AAAAACCGTTTTATTGTTA -> AAAACCGTTTTATTGTTAT
AAAAATACAGTCTGATGCG -> AAAATACAGTCTGATGCGT
AAAACCACGGAAGGACCGG -> AAACCACGGAAGGACCGGA
AAAACCGTTTTATTGTTAT -> AAACCGTTTTATTGTTATA
AAAAGAAATTTGGCGTGAG -> AAAGAAATTTGGCGTGAGC
AAAAGTGAGACACAAGCTA -> AAAGTGAGACACAAGCTAA
AAAATACAGTCTGATGCGT -> AAATACAGTCTGATGCGTA
AAAATCGTCGCTCGCCGAG -> AAATCGTCGCTCGCCGAGC
AAAATGCCCCGGTCTTAGG -> AAATGCCCCGGTCTTAGGG
AAACAAGTTTATTCGGTGT -> AACAAGTTTATTCGGTGTA
AAACAGTCCTATAATAACT -> AACAGTCCTATAATAACTC
AAACCACGGAAGGACCGGA -> AACCACGGAAGGACCGGAG
AAACCGTTTTATTGTTATA -> AACCGTTTTATTGTTATAG
AAACGAGGTGGCCCCCTGT -> AACGAGGTGGCCCCCTGTC
AAACGCCAGGGCATCTCTT -> AACGCCAGGGCATCTCTTT
AAACGGGGTCCTTAGTGAA -> AACGGGGTCCTTAGTGAAA
AAACTCGCCGGTGATCAAC -> AACTCGCCGGTGATCAACC
AAACTGCTACCATCGGGAT -> AACTGCTACCATCGGGATC
AAAGAAATTTGGCGTGAGC -> AAGAAATTTGGCGTGAGCG
AAAGAACGAAACTCGCCGG -> AAGAACGAAACTCGCCGGT
AAAGAATAACGCGGCTGTT -> AAGAATAACGCGGCTGTTC
AAAGATCGTGGACGAAATT -> AAGATCGTGGACGAAATTA
AAAGCACCCGCACTACACT -> AAGCACCCGCACTACACTT
AAAGGCGGATTATTTGTCA -> AAGGCGGATTATTTGTCAC
AAAGTGAGACACAAGCTAA -> AAGTGAGACACAAGCTAAG
AAAGTGAGACACAAGCTAC -> AAGTGAGACACAAGCTACC
AAAGTGAGACACAAGCTAG -> AAGTGAGACACAAGCTAGG
AAAGTGAGACACAAGCTAT -> AAGTGAGACACAAGCTATG
AAATACAGTCTGATGCGTA -> AATACAGTCTGATGCGTAG
AAATCGCCGATAGTCCGTA -> AATCGCCGATAGTCCGTAA
AAATCGTCGCTCGCCGAGC -> AATCGTCGCTCGCCGAGCA
AAATGCCCCGGTCTTAGGG -> AATGCCCCGGTCTTAGGGG
AAATTATACATGAGTGTTC -> AATTATACATGAGTGTTCC
AAATTCTGTCACTGACTCT -> AATTCTGTCACTGACTCTT
AAATTTGGCGTGAGCGACC -> AATTTGGCGTGAGCGACCT
AACAAGTTTATTCGGTGTA -> ACAAGTTTATTCGGTGTAC
AACACGATTCCACATTAGA -> ACACGATTCCACATTAGAT
AACACTAGCATAGCGACAT -> ACACTAGCATAGCGACATT
AACAGTCCTATAATAACTC -> ACAGTCCTATAATAACTCC
AACATAGTTACTCAGTTTA -> ACATAGTTACTCAGTTTAA
AACCAAAGCACCCGCACTA -> ACCAAAGCACCCGCACTAC
AACCACGGAAGGACCGGAG -> ACCACGGAAGGACCGGAGT
AACCCACTAAGGGACCGTA -> ACCCACTAAGGGACCGTAT
AACCCTACCGTTCTGTGGC -> ACCCTACCGTTCTGTGGCT
AACCCTACCTCCGGTAGAA -> ACCCTACCTCCGGTAGAAT
AACCGTTTTATTGTTATAG -> ACCGTTTTATTGTTATAGG
AACCTGCGGCGACTACTGG -> ACCTGCGGCGACTACTGGG
AACCTGTGATCGTAAAACC -> ACCTGTGATCGTAAAACCA
AACCTTCAAGATTAAAAAT -> ACCTTCAAGATTAAAAATA
AACGAAACTCGCCGGTGAT -> ACGAAACTCGCCGGTGATC
AACGAGGTGGCCCCCTGTC -> ACGAGGTGGCCCCCTGTCT
AACGATAGTGCCCGCCTCG -> ACGATAGTGCCCGCCTCGA
AACGATGTTCGAAGAACGA -> ACGATGTTCGAAGAACGAT
AACGATTTAGCTTCAAACA -> ACGATTTAGCTTCAAACAA
AACGCCAGGGCATCTCTTT -> ACGCCAGGGCATCTCTTTA
AACGCGGCTGTTCCAATTT -> ACGCGGCTGTTCCAATTTG
AACGGCTGTACATCCCGGG -> ACGGCTGTACATCCCGGGG
AACGGGGTCCTTAGTGAAA -> ACGGGGTCCTTAGTGAAAG
AACGTGCTGCGAGTATTAC -> ACGTGCTGCGAGTATTACA
AACTACGCGGTCTGAAGGA -> ACTACGCGGTCTGAAGGAG
AACTACTTAATTTTCCCTA -> ACTACTTAATTTTCCCTAC
AACTCCGCCGATGAAGTAA -> ACTCCGCCGATGAAGTAAA
AACTCGCCGGTGATCAACC -> ACTCGCCGGTGATCAACCA
AACTGATGCCAGATTATAA -> ACTGATGCCAGATTATAAC
AACTGCATAAATTCTGTCA -> ACTGCATAAATTCTGTCAC
AACTGCTACCATCGGGATC -> ACTGCTACCATCGGGATCT
AAGAAATTTGGCGTGAGCG -> AGAAATTTGGCGTGAGCGA
AAGAACGAAACTCGCCGGT -> AGAACGAAACTCGCCGGTG
AAGAACGATAGTGCCCGCC -> AGAACGATAGTGCCCGCCT
AAGAATAACGCGGCTGTTC -> AGAATAACGCGGCTGTTCC
AAGAGCCTTACGATTCGAC -> AGAGCCTTACGATTCGACA
AAGAGTACACACAGTGTTA -> AGAGTACACACAGTGTTAA
AAGATCAGTTAAGGTTACG -> AGATCAGTTAAGGTTACGT
AAGATCGTGGACGAAATTA -> AGATCGTGGACGAAATTAT
AAGATGACGAGAATGATCC -> AGATGACGAGAATGATCCT
AAGATGAGTGTGAAAAGTG -> AGATGAGTGTGAAAAGTGA
AAGATTAAAAATACAGTCT -> AGATTAAAAATACAGTCTG
AAGATTTGACAGCTCCTAG -> AGATTTGACAGCTCCTAGA
AAGCAATTGCTGGTTCCAA -> AGCAATTGCTGGTTCCAAA
AAGCACACACCAAACGAGG -> AGCACACACCAAACGAGGT
AAGCACCCGCACTACACTT -> AGCACCCGCACTACACTTG
AAGCATGGTTAAAATCGTC -> AGCATGGTTAAAATCGTCG
AAGCCCGGCCTTATTACAT -> AGCCCGGCCTTATTACATC
AAGCGATAGGTGACACGGT -> AGCGATAGGTGACACGGTA
AAGCTAAGCTAGGAGTTTC -> AGCTAAGCTAGGAGTTTCG
AAGCTACCACTTTGCGATC -> AGCTACCACTTTGCGATCG
AAGCTAGGAGTTTCGTCGT -> AGCTAGGAGTTTCGTCGTG
AAGCTAGGGCATAGTGCTC -> AGCTAGGGCATAGTGCTCG
AAGCTATGTACAGCGCGTC -> AGCTATGTACAGCGCGTCG
AAGGACCGGAGTGAAAGAA -> AGGACCGGAGTGAAAGAAC
AAGGACGTGGCGGCCGATT -> AGGACGTGGCGGCCGATTC
AAGGAGGTGCCCTAGTGAG -> AGGAGGTGCCCTAGTGAGT
AAGGCGGATTATTTGTCAC -> AGGCGGATTATTTGTCACA
AAGGGACAAACAGTCCTAT -> AGGGACAAACAGTCCTATA
AAGGGACAGAACACGATTC -> AGGGACAGAACACGATTCC
AAGGGACCGTATAATATCG -> AGGGACCGTATAATATCGC
AAGGTTACGTTGAAGCATG -> AGGTTACGTTGAAGCATGG
AAGGTTTATGAAGATGAGT -> AGGTTTATGAAGATGAGTG
AAGTAAAATGCCCCGGTCT -> AGTAAAATGCCCCGGTCTT
AAGTACCAAACGCCAGGGC -> AGTACCAAACGCCAGGGCA
AAGTGAGACACAAGCTAAG -> AGTGAGACACAAGCTAAGC
AAGTGAGACACAAGCTACC -> AGTGAGACACAAGCTACCA
AAGTGAGACACAAGCTAGG -> AGTGAGACACAAGCTAGGG
AAGTGAGACACAAGCTATG -> AGTGAGACACAAGCTATGT
AAGTGAGGCAGGTCGAACT -> AGTGAGGCAGGTCGAACTA
AAGTTTATTCGGTGTACCC -> AGTTTATTCGGTGTACCCT
AATAAAGTGAGACACAAGC -> ATAAAGTGAGACACAAGCT
AATAACGCGGCTGTTCCAA -> ATAACGCGGCTGTTCCAAT
AATAACTCCGCCGATGAAG -> ATAACTCCGCCGATGAAGT
AATAAGGTTTATGAAGATG -> ATAAGGTTTATGAAGATGA
AATAATCTAGATACTTTGG -> ATAATCTAGATACTTTGGT
AATACAGTCTGATGCGTAG -> ATACAGTCTGATGCGTAGC
AATACGAGAACACTAGCAT -> ATACGAGAACACTAGCATA
AATAGATAACTGATGCCAG -> ATAGATAACTGATGCCAGA
AATATAGAGGGCCAGTACG -> ATATAGAGGGCCAGTACGC
AATATAGGCCTCTAGTCTT -> ATATAGGCCTCTAGTCTTT
AATATCGCCCAAAGAATAA -> ATATCGCCCAAAGAATAAC
AATCCTATTCAATGAGCGC -> ATCCTATTCAATGAGCGCC
AATCGCCGATAGTCCGTAA -> ATCGCCGATAGTCCGTAAG
AATCGTCGCTCGCCGAGCA -> ATCGTCGCTCGCCGAGCAG
AATCTAGATACTTTGGTAT -> ATCTAGATACTTTGGTATC
AATGAGCGCCCGATAGGTT -> ATGAGCGCCCGATAGGTTA
AATGATAATTCACAGGAGT -> ATGATAATTCACAGGAGTA
AATGATCCTCAACGGCTGT -> ATGATCCTCAACGGCTGTA
AATGCCATTTGGCTAAGCC -> ATGCCATTTGGCTAAGCCC
AATGCCCCGGTCTTAGGGG -> ATGCCCCGGTCTTAGGGGA
AATGTACTGTGGCGAGTAA -> ATGTACTGTGGCGAGTAAT
AATGTATGAGCCATGCCCC -> ATGTATGAGCCATGCCCCG
AATTACCAGCGCCTCGACA -> ATTACCAGCGCCTCGACAT
AATTATACATGAGTGTTCC -> ATTATACATGAGTGTTCCA
AATTCACAGGAGTAGACAC -> ATTCACAGGAGTAGACACC
AATTCCATTGCGACTAGTC -> ATTCCATTGCGACTAGTCA
AATTCTGTCACTGACTCTT -> ATTCTGTCACTGACTCTTT
AATTGAGTCCCCCTCCTAA -> ATTGAGTCCCCCTCCTAAT
AATTGCTGGTTCCAAAAAC -> ATTGCTGGTTCCAAAAACC
AATTGGCACACTGCTACTC -> ATTGGCACACTGCTACTCG
AATTGTCTGCATCTGACGC -> ATTGTCTGCATCTGACGCT
AATTTCAACCTGTGATCGT -> ATTTCAACCTGTGATCGTA
AATTTGATATCGTCATACT -> ATTTGATATCGTCATACTG
AATTTGCAGGTCAATAAGG -> ATTTGCAGGTCAATAAGGT
AATTTGGCGTGAGCGACCT -> ATTTGGCGTGAGCGACCTA
AATTTGTTCCAACCTGCGG -> ATTTGTTCCAACCTGCGGC
AATTTTCCCTACCCCAACA -> ATTTTCCCTACCCCAACAT
ACAAAAGAAATTTGGCGTG -> CAAAAGAAATTTGGCGTGA
ACAAACAGTCCTATAATAA -> CAAACAGTCCTATAATAAC
ACAAAGTGAGACACAAGCT -> CAAAGTGAGACACAAGCTA
ACAACTACGCGGTCTGAAG -> CAACTACGCGGTCTGAAGG
ACAAGATGACGAGAATGAT -> CAAGATGACGAGAATGATC
ACAAGCTAAGCTAGGAGTT -> CAAGCTAAGCTAGGAGTTT
ACAAGCTACCACTTTGCGA -> CAAGCTACCACTTTGCGAT
ACAAGCTAGGGCATAGTGC -> CAAGCTAGGGCATAGTGCT
ACAAGCTATGTACAGCGCG -> CAAGCTATGTACAGCGCGT
ACAAGTTTATTCGGTGTAC -> CAAGTTTATTCGGTGTACC
ACAATGTATGAGCCATGCC -> CAATGTATGAGCCATGCCC
ACAATTACCAGCGCCTCGA -> CAATTACCAGCGCCTCGAC
ACACAAGCTAAGCTAGGAG -> CACAAGCTAAGCTAGGAGT
ACACAAGCTACCACTTTGC -> CACAAGCTACCACTTTGCG
ACACAAGCTAGGGCATAGT -> CACAAGCTAGGGCATAGTG
ACACAAGCTATGTACAGCG -> CACAAGCTATGTACAGCGC
ACACACAGTGTTAATTTCA -> CACACAGTGTTAATTTCAA
ACACACCAAACGAGGTGGC -> CACACCAAACGAGGTGGCC
ACACAGTGTTAATTTCAAC -> CACAGTGTTAATTTCAACC
ACACCAAACGAGGTGGCCC -> CACCAAACGAGGTGGCCCC
ACACCAACCCACTAAGGGA -> CACCAACCCACTAAGGGAC
ACACGATTCCACATTAGAT -> CACGATTCCACATTAGATA
ACACGGTAGATTACACTAC -> CACGGTAGATTACACTACA
ACACTACAAAAGAAATTTG -> CACTACAAAAGAAATTTGG
ACACTAGCATAGCGACATT -> CACTAGCATAGCGACATTT
ACACTCCCAACTGCATAAA -> CACTCCCAACTGCATAAAT
ACACTGCTACTCGGAGGTT -> CACTGCTACTCGGAGGTTA
ACACTTGTACGGTGATGCA -> CACTTGTACGGTGATGCAG
ACAGAACACGATTCCACAT -> CAGAACACGATTCCACATT
ACAGATGGCAGTAAGAGTA -> CAGATGGCAGTAAGAGTAC
ACAGCGCGTCGTCGTGCTC -> CAGCGCGTCGTCGTGCTCA
ACAGCTCCTAGAAGTGAGG -> CAGCTCCTAGAAGTGAGGC
ACAGGAGTAGACACCAACC -> CAGGAGTAGACACCAACCC
ACAGGCGACTCGTACCTGC -> CAGGCGACTCGTACCTGCG
ACAGTCCTATAATAACTCC -> CAGTCCTATAATAACTCCG
ACAGTCTATACTTCATGTC -> CAGTCTATACTTCATGTCG
ACAGTCTGATGCGTAGCAG -> CAGTCTGATGCGTAGCAGA
ACAGTGTTAATTTCAACCT -> CAGTGTTAATTTCAACCTG
ACATAGTTACTCAGTTTAA -> CATAGTTACTCAGTTTAAA
ACATCATTGACAGATGGCA -> CATCATTGACAGATGGCAG
ACATCCCGGGGAGGTGCTC -> CATCCCGGGGAGGTGCTCC
ACATGAAGATCAGTTAAGG -> CATGAAGATCAGTTAAGGT
ACATGAGTGTTCCATAATT -> CATGAGTGTTCCATAATTG
ACATTAGATAAAGGCGGAT -> CATTAGATAAAGGCGGATT
ACATTTAGCAGACCCCCGC -> CATTTAGCAGACCCCCGCA
ACCAAACGAGGTGGCCCCC -> CCAAACGAGGTGGCCCCCT
ACCAAACGCCAGGGCATCT -> CCAAACGCCAGGGCATCTC
ACCAAAGCACCCGCACTAC -> CCAAAGCACCCGCACTACA
ACCAACCCACTAAGGGACC -> CCAACCCACTAAGGGACCG
ACCAATTTGTTCCAACCTG -> CCAATTTGTTCCAACCTGC
ACCACGGAAGGACCGGAGT -> CCACGGAAGGACCGGAGTG
ACCACTTTGCGATCGTCGT -> CCACTTTGCGATCGTCGTG
ACCAGCGCCTCGACATGAA -> CCAGCGCCTCGACATGAAG
ACCATCAGCTTTCCGAGGC -> CCATCAGCTTTCCGAGGCT
ACCATCGGGATCTTATCAA -> CCATCGGGATCTTATCAAT
ACCCACTAAGGGACCGTAT -> CCCACTAAGGGACCGTATA
ACCCCAACATAGTTACTCA -> CCCCAACATAGTTACTCAG
ACCCCCGCAACCTTCAAGA -> CCCCCGCAACCTTCAAGAT
ACCCGAATTCCATTGCGAC -> CCCGAATTCCATTGCGACT
ACCCGCACTACACTTGTAC -> CCCGCACTACACTTGTACG
ACCCGTAACGATTTAGCTT -> CCCGTAACGATTTAGCTTC
ACCCTACCGTTCTGTGGCT -> CCCTACCGTTCTGTGGCTC
ACCCTACCTCCGGTAGAAT -> CCCTACCTCCGGTAGAATT
ACCCTTAATTTGATATCGT -> CCCTTAATTTGATATCGTC
ACCCTTTTGGCAGCGACAA -> CCCTTTTGGCAGCGACAAA
ACCGGAGTGAAAGAACGAA -> CCGGAGTGAAAGAACGAAA
ACCGTATAATATCGCCCAA -> CCGTATAATATCGCCCAAA
ACCGTTCTGTGGCTCGACA -> CCGTTCTGTGGCTCGACAG
ACCGTTTTATTGTTATAGG -> CCGTTTTATTGTTATAGGC
ACCTATACTCATGGCGAGA -> CCTATACTCATGGCGAGAC
ACCTATCCTGGCTGCGTAC -> CCTATCCTGGCTGCGTACT
ACCTCCAAATCGCCGATAG -> CCTCCAAATCGCCGATAGT
ACCTCCGGTAGAATTGGCA -> CCTCCGGTAGAATTGGCAC
ACCTGCGAAGTACCAAACG -> CCTGCGAAGTACCAAACGC
ACCTGCGGCGACTACTGGG -> CCTGCGGCGACTACTGGGG
ACCTGTGATCGTAAAACCA -> CCTGTGATCGTAAAACCAC
ACCTTCAAGATTAAAAATA -> CCTTCAAGATTAAAAATAC
ACCTTCTCATTGCGGTTGG -> CCTTCTCATTGCGGTTGGG
ACGAAACTCGCCGGTGATC -> CGAAACTCGCCGGTGATCA
ACGAAATTATACATGAGTG -> CGAAATTATACATGAGTGT
ACGACCTCCAAATCGCCGA -> CGACCTCCAAATCGCCGAT
ACGAGAACACTAGCATAGC -> CGAGAACACTAGCATAGCG
ACGAGAATGATCCTCAACG -> CGAGAATGATCCTCAACGG
ACGAGGTGGCCCCCTGTCT -> CGAGGTGGCCCCCTGTCTG
ACGATAGTGCCCGCCTCGA -> CGATAGTGCCCGCCTCGAG
ACGATGTTCGAAGAACGAT -> CGATGTTCGAAGAACGATA
ACGATTCCACATTAGATAA -> CGATTCCACATTAGATAAA
ACGATTCGACAAGATGACG -> CGATTCGACAAGATGACGA
ACGATTTAGCTTCAAACAA -> CGATTTAGCTTCAAACAAG
ACGCAGACTTTCCCTTCGA -> CGCAGACTTTCCCTTCGAG
ACGCAGTACTCCGCCCGAT -> CGCAGTACTCCGCCCGATG
ACGCCAGGGCATCTCTTTA -> CGCCAGGGCATCTCTTTAC
ACGCGGCTGTTCCAATTTG -> CGCGGCTGTTCCAATTTGC
ACGCGGTCTGAAGGAGGTG -> CGCGGTCTGAAGGAGGTGC
ACGCTGGTCGCTGGGCCTA -> CGCTGGTCGCTGGGCCTAG
ACGGAAGGACCGGAGTGAA -> CGGAAGGACCGGAGTGAAA
ACGGCTAGCTTTCACTAGT -> CGGCTAGCTTTCACTAGTT
ACGGCTGTACATCCCGGGG -> CGGCTGTACATCCCGGGGA
ACGGGGTCCTTAGTGAAAG -> CGGGGTCCTTAGTGAAAGA
ACGGTAGATTACACTACAA -> CGGTAGATTACACTACAAA
ACGGTGATGCAGGGCGCGT -> CGGTGATGCAGGGCGCGTG
ACGTGCTGCGAGTATTACA -> CGTGCTGCGAGTATTACAG
ACGTGGCGGCCGATTCCGC -> CGTGGCGGCCGATTCCGCT
ACGTTGAAGCATGGTTAAA -> CGTTGAAGCATGGTTAAAA
ACTAAGGGACCGTATAATA -> CTAAGGGACCGTATAATAT
ACTACAAAAGAAATTTGGC -> CTACAAAAGAAATTTGGCG
ACTACACTTGTACGGTGAT -> CTACACTTGTACGGTGATG
ACTACGCGGTCTGAAGGAG -> CTACGCGGTCTGAAGGAGG
ACTACTGGGGGTGGTAATG -> CTACTGGGGGTGGTAATGT
ACTACTTAATTTTCCCTAC -> CTACTTAATTTTCCCTACC
ACTAGCATAGCGACATTTA -> CTAGCATAGCGACATTTAG
ACTAGTCACAACTACGCGG -> CTAGTCACAACTACGCGGT
ACTAGTTAACCCTACCGTT -> CTAGTTAACCCTACCGTTC
ACTATCCCCGTATAATGCC -> CTATCCCCGTATAATGCCA
ACTCAGTTTAAACTGCTAC -> CTCAGTTTAAACTGCTACC
ACTCATGGCGAGACTATCC -> CTCATGGCGAGACTATCCC
ACTCCCAACTGCATAAATT -> CTCCCAACTGCATAAATTC
ACTCCCTCTGAGTGTGGCT -> CTCCCTCTGAGTGTGGCTC
ACTCCGCCCGATGTCGGGT -> CTCCGCCCGATGTCGGGTC
ACTCCGCCGATGAAGTAAA -> CTCCGCCGATGAAGTAAAA
ACTCGCCGGTGATCAACCA -> CTCGCCGGTGATCAACCAA
ACTCGGAGGTTATGCAATG -> CTCGGAGGTTATGCAATGA
ACTCGTACCTGCGAAGTAC -> CTCGTACCTGCGAAGTACC
ACTCTGCTTATCGCACGCA -> CTCTGCTTATCGCACGCAT
ACTCTGTTGGGTAGATTTA -> CTCTGTTGGGTAGATTTAC
ACTCTTTGTCGCGGTAAGC -> CTCTTTGTCGCGGTAAGCG
ACTGACGGCTAGCTTTCAC -> CTGACGGCTAGCTTTCACT
ACTGACTCTTTGTCGCGGT -> CTGACTCTTTGTCGCGGTA
ACTGATGCCAGATTATAAC -> CTGATGCCAGATTATAACC
ACTGCATAAATTCTGTCAC -> CTGCATAAATTCTGTCACT
ACTGCGCGTTGTTCGGATA -> CTGCGCGTTGTTCGGATAC
ACTGCTACCATCGGGATCT -> CTGCTACCATCGGGATCTT
ACTGCTACTCGGAGGTTAT -> CTGCTACTCGGAGGTTATG
ACTGGCCGCTCCTTGGTAC -> CTGGCCGCTCCTTGGTACC
ACTGGGGGTGGTAATGTAC -> CTGGGGGTGGTAATGTACT
ACTGGTGCTCCAGGGCACC -> CTGGTGCTCCAGGGCACCT
ACTGTGGCGAGTAATAGAT -> CTGTGGCGAGTAATAGATA
ACTTAATTTTCCCTACCCC -> CTTAATTTTCCCTACCCCA
ACTTCATGTCGATCTACTG -> CTTCATGTCGATCTACTGA
ACTTGTACGGTGATGCAGG -> CTTGTACGGTGATGCAGGG
ACTTTCCCTTCGAGCTACC -> CTTTCCCTTCGAGCTACCA
ACTTTGCGATCGTCGTGCT -> CTTTGCGATCGTCGTGCTC
ACTTTGGTATCATCTCACA -> CTTTGGTATCATCTCACAA
AGAAATTTGGCGTGAGCGA -> GAAATTTGGCGTGAGCGAC
AGAACACGATTCCACATTA -> GAACACGATTCCACATTAG
AGAACACTAGCATAGCGAC -> GAACACTAGCATAGCGACA
AGAACGAAACTCGCCGGTG -> GAACGAAACTCGCCGGTGA
AGAACGATAGTGCCCGCCT -> GAACGATAGTGCCCGCCTC
AGAACGATGTTCGAAGAAC -> GAACGATGTTCGAAGAACG
AGAAGGGACAAACAGTCCT -> GAAGGGACAAACAGTCCTA
AGAAGTGAGGCAGGTCGAA -> GAAGTGAGGCAGGTCGAAC
AGAATAACGCGGCTGTTCC -> GAATAACGCGGCTGTTCCA
AGAATGATCCTCAACGGCT -> GAATGATCCTCAACGGCTG
AGAATTGGCACACTGCTAC -> GAATTGGCACACTGCTACT
AGACACAAGCTAAGCTAGG -> GACACAAGCTAAGCTAGGA
AGACACAAGCTACCACTTT -> GACACAAGCTACCACTTTG
AGACACAAGCTAGGGCATA -> GACACAAGCTAGGGCATAG
AGACACAAGCTATGTACAG -> GACACAAGCTATGTACAGC
AGACACCAACCCACTAAGG -> GACACCAACCCACTAAGGG
AGACCCCCGCAACCTTCAA -> GACCCCCGCAACCTTCAAG
AGACCCGTAACGATTTAGC -> GACCCGTAACGATTTAGCT
AGACTATCCCCGTATAATG -> GACTATCCCCGTATAATGC
AGACTTTCCCTTCGAGCTA -> GACTTTCCCTTCGAGCTAC
AGAGCAGTTCATGGAAAGT -> GAGCAGTTCATGGAAAGTG
AGAGCCATATTGACCAATT -> GAGCCATATTGACCAATTT
AGAGCCTTACGATTCGACA -> GAGCCTTACGATTCGACAA
AGAGGGCCAGTACGCAGAC -> GAGGGCCAGTACGCAGACT
AGAGTACACACAGTGTTAA -> GAGTACACACAGTGTTAAT
AGATAAAGGCGGATTATTT -> GATAAAGGCGGATTATTTG
AGATAACTGATGCCAGATT -> GATAACTGATGCCAGATTA
AGATACTTTGGTATCATCT -> GATACTTTGGTATCATCTC
AGATCAGTTAAGGTTACGT -> GATCAGTTAAGGTTACGTT
AGATCGTGGACGAAATTAT -> GATCGTGGACGAAATTATA
AGATGACGAGAATGATCCT -> GATGACGAGAATGATCCTC
AGATGAGTGTGAAAAGTGA -> GATGAGTGTGAAAAGTGAG
AGATGGCAGTAAGAGTACA -> GATGGCAGTAAGAGTACAC
AGATTAAAAATACAGTCTG -> GATTAAAAATACAGTCTGA
AGATTACACTACAAAAGAA -> GATTACACTACAAAAGAAA
AGATTATAACCCTACCTCC -> GATTATAACCCTACCTCCG
AGATTTACCCTTAATTTGA -> GATTTACCCTTAATTTGAT
AGATTTGACAGCTCCTAGA -> GATTTGACAGCTCCTAGAA
AGCAAACGGGGTCCTTAGT -> GCAAACGGGGTCCTTAGTG
AGCAATTGCTGGTTCCAAA -> GCAATTGCTGGTTCCAAAA
AGCACACACCAAACGAGGT -> GCACACACCAAACGAGGTG
AGCACCCGCACTACACTTG -> GCACCCGCACTACACTTGT
AGCACGACCTCCAAATCGC -> GCACGACCTCCAAATCGCC
AGCAGACCCCCGCAACCTT -> GCAGACCCCCGCAACCTTC
AGCAGAGCAGTTCATGGAA -> GCAGAGCAGTTCATGGAAA
AGCAGGTCTGCCGCTTTCT -> GCAGGTCTGCCGCTTTCTT
AGCAGTGTAGCTCGACACT -> GCAGTGTAGCTCGACACTC
AGCAGTTCATGGAAAGTGA -> GCAGTTCATGGAAAGTGAG
AGCATAGCGACATTTAGCA -> GCATAGCGACATTTAGCAG
AGCATCGTAGCCGGTAGCA -> GCATCGTAGCCGGTAGCAC
AGCATGGTTAAAATCGTCG -> GCATGGTTAAAATCGTCGC
AGCCATATTGACCAATTTG -> GCCATATTGACCAATTTGT
AGCCATGCCCCGGTACTCT -> GCCATGCCCCGGTACTCTG
AGCCCGGCCTTATTACATC -> GCCCGGCCTTATTACATCA
AGCCGGTAGCACGACCTCC -> GCCGGTAGCACGACCTCCA
AGCCTTACGATTCGACAAG -> GCCTTACGATTCGACAAGA
AGCGACAAAGTGAGACACA -> GCGACAAAGTGAGACACAA
AGCGACATTTAGCAGACCC -> GCGACATTTAGCAGACCCC
AGCGACCTATACTCATGGC -> GCGACCTATACTCATGGCG
AGCGATAGGTGACACGGTA -> GCGATAGGTGACACGGTAG
AGCGCCCGATAGGTTACTC -> GCGCCCGATAGGTTACTCT
AGCGCCTCGACATGAAGAT -> GCGCCTCGACATGAAGATC
AGCGCGTCGTCGTGCTCAG -> GCGCGTCGTCGTGCTCAGT
AGCTAAGCTAGGAGTTTCG -> GCTAAGCTAGGAGTTTCGT
AGCTACCACTTTGCGATCG -> GCTACCACTTTGCGATCGT
AGCTACCATCAGCTTTCCG -> GCTACCATCAGCTTTCCGA
AGCTAGGAGTTTCGTCGTG -> GCTAGGAGTTTCGTCGTGC
AGCTAGGGCATAGTGCTCG -> GCTAGGGCATAGTGCTCGT
AGCTATGTACAGCGCGTCG -> GCTATGTACAGCGCGTCGT
AGCTCCTAGAAGTGAGGCA -> GCTCCTAGAAGTGAGGCAG
AGCTCGACACTCCCAACTG -> GCTCGACACTCCCAACTGC
AGCTGCGGAATATAGGCCT -> GCTGCGGAATATAGGCCTC
AGCTTCAAACAAGTTTATT -> GCTTCAAACAAGTTTATTC
AGCTTTCACTAGTTAACCC -> GCTTTCACTAGTTAACCCT
AGCTTTCCGAGGCTCCGAT -> GCTTTCCGAGGCTCCGATT
AGGACCGGAGTGAAAGAAC -> GGACCGGAGTGAAAGAACG
AGGACGTGGCGGCCGATTC -> GGACGTGGCGGCCGATTCC
AGGAGGTGCCCTAGTGAGT -> GGAGGTGCCCTAGTGAGTA
AGGAGTAGACACCAACCCA -> GGAGTAGACACCAACCCAC
AGGAGTTTCGTCGTGCTCA -> GGAGTTTCGTCGTGCTCAG
AGGCAGACCCGTAACGATT -> GGCAGACCCGTAACGATTT
AGGCAGGTCGAACTACTTA -> GGCAGGTCGAACTACTTAA
AGGCCAGAACGATGTTCGA -> GGCCAGAACGATGTTCGAA
AGGCCTCTAGTCTTTTACC -> GGCCTCTAGTCTTTTACCC
AGGCGACTCGTACCTGCGA -> GGCGACTCGTACCTGCGAA
AGGCGGATTATTTGTCACA -> GGCGGATTATTTGTCACAA
AGGCTCCGATTAGCATCGT -> GGCTCCGATTAGCATCGTA
AGGGACAAACAGTCCTATA -> GGGACAAACAGTCCTATAA
AGGGACAGAACACGATTCC -> GGGACAGAACACGATTCCA
AGGGACCGTATAATATCGC -> GGGACCGTATAATATCGCC
AGGGCACCTTCTCATTGCG -> GGGCACCTTCTCATTGCGG
AGGGCATAGTGCTCGTCGT -> GGGCATAGTGCTCGTCGTG
AGGGCATCTCTTTACGCAG -> GGGCATCTCTTTACGCAGT
AGGGCCAGTACGCAGACTT -> GGGCCAGTACGCAGACTTT
AGGGCGCGTGAGTGTGCAA -> GGGCGCGTGAGTGTGCAAT
AGGGGATAACGTGCTGCGA -> GGGGATAACGTGCTGCGAG
AGGTCAATAAGGTTTATGA -> GGTCAATAAGGTTTATGAA
AGGTCGAACTACTTAATTT -> GGTCGAACTACTTAATTTT
AGGTCTGCCGCTTTCTTCT -> GGTCTGCCGCTTTCTTCTG
AGGTGACACGGTAGATTAC -> GGTGACACGGTAGATTACA
AGGTGCCCTAGTGAGTATT -> GGTGCCCTAGTGAGTATTC
AGGTGCTCCGTTCGTTTGA -> GGTGCTCCGTTCGTTTGAC
AGGTGGCCCCCTGTCTGTA -> GGTGGCCCCCTGTCTGTAA
AGGTTACGTTGAAGCATGG -> GGTTACGTTGAAGCATGGT
AGGTTACTCTGCTTATCGC -> GGTTACTCTGCTTATCGCA
AGGTTATGCAATGATAATT -> GGTTATGCAATGATAATTC
AGGTTTATGAAGATGAGTG -> GGTTTATGAAGATGAGTGT
AGTAAAATGCCCCGGTCTT -> GTAAAATGCCCCGGTCTTA
AGTAAGAGTACACACAGTG -> GTAAGAGTACACACAGTGT
AGTAATAGATAACTGATGC -> GTAATAGATAACTGATGCC
AGTACACACAGTGTTAATT -> GTACACACAGTGTTAATTT
AGTACCAAACGCCAGGGCA -> GTACCAAACGCCAGGGCAT
AGTACGCAGACTTTCCCTT -> GTACGCAGACTTTCCCTTC
AGTACTCCGCCCGATGTCG -> GTACTCCGCCCGATGTCGG
AGTAGACACCAACCCACTA -> GTAGACACCAACCCACTAA
AGTATGAAGAGCCTTACGA -> GTATGAAGAGCCTTACGAT
AGTATGAAGGACGTGGCGG -> GTATGAAGGACGTGGCGGC
AGTATGAAGGGACAGAACA -> GTATGAAGGGACAGAACAC
AGTATGAATAATCTAGATA -> GTATGAATAATCTAGATAC
AGTATTACAGTCTATACTT -> GTATTACAGTCTATACTTC
AGTATTCTTGTCTCAAGCA -> GTATTCTTGTCTCAAGCAC
AGTCACAACTACGCGGTCT -> GTCACAACTACGCGGTCTG
AGTCCCCCTCCTAATCCTA -> GTCCCCCTCCTAATCCTAT
AGTCCGTAAGATTTGACAG -> GTCCGTAAGATTTGACAGC
AGTCCTATAATAACTCCGC -> GTCCTATAATAACTCCGCC
AGTCTATACTTCATGTCGA -> GTCTATACTTCATGTCGAT
AGTCTGATGCGTAGCAGAG -> GTCTGATGCGTAGCAGAGC
AGTCTTTTACCCGAATTCC -> GTCTTTTACCCGAATTCCA
AGTGAAAGAACGAAACTCG -> GTGAAAGAACGAAACTCGC
AGTGAAAGATCGTGGACGA -> GTGAAAGATCGTGGACGAA
AGTGAGACACAAGCTAAGC -> GTGAGACACAAGCTAAGCT
AGTGAGACACAAGCTACCA -> GTGAGACACAAGCTACCAC
AGTGAGACACAAGCTAGGG -> GTGAGACACAAGCTAGGGC
AGTGAGACACAAGCTATGT -> GTGAGACACAAGCTATGTA
AGTGAGGCAGGTCGAACTA -> GTGAGGCAGGTCGAACTAC
AGTGAGTATTCTTGTCTCA -> GTGAGTATTCTTGTCTCAA
AGTGCCCGCCTCGAGCAGG -> GTGCCCGCCTCGAGCAGGT
AGTGCTCGTCGTGCTCAGT -> GTGCTCGTCGTGCTCAGTA
AGTGTAGCTCGACACTCCC -> GTGTAGCTCGACACTCCCA
AGTGTGAAAAGTGAGACAC -> GTGTGAAAAGTGAGACACA
AGTGTGCAATACGAGAACA -> GTGTGCAATACGAGAACAC
AGTGTGGCTCAGCAAACGG -> GTGTGGCTCAGCAAACGGG
AGTGTTAATTTCAACCTGT -> GTGTTAATTTCAACCTGTG
AGTGTTCCATAATTGTCTG -> GTGTTCCATAATTGTCTGC
AGTTAACCCTACCGTTCTG -> GTTAACCCTACCGTTCTGT
AGTTAAGGTTACGTTGAAG -> GTTAAGGTTACGTTGAAGC
AGTTACTCAGTTTAAACTG -> GTTACTCAGTTTAAACTGC
AGTTCATGGAAAGTGAGAC -> GTTCATGGAAAGTGAGACA
AGTTTAAACTGCTACCATC -> GTTTAAACTGCTACCATCG
AGTTTATTCGGTGTACCCT -> GTTTATTCGGTGTACCCTT
AGTTTCGTCGTGCTCAGTA -> GTTTCGTCGTGCTCAGTAT
ATAAAGGCGGATTATTTGT -> TAAAGGCGGATTATTTGTC
ATAAAGTGAGACACAAGCT -> TAAAGTGAGACACAAGCTA
ATAAATTCTGTCACTGACT -> TAAATTCTGTCACTGACTC
ATAACCCTACCTCCGGTAG -> TAACCCTACCTCCGGTAGA
ATAACGCGGCTGTTCCAAT -> TAACGCGGCTGTTCCAATT
ATAACGTGCTGCGAGTATT -> TAACGTGCTGCGAGTATTA
ATAACTCCGCCGATGAAGT -> TAACTCCGCCGATGAAGTA
ATAACTGATGCCAGATTAT -> TAACTGATGCCAGATTATA
ATAAGGTTTATGAAGATGA -> TAAGGTTTATGAAGATGAG
ATAATAACTCCGCCGATGA -> TAATAACTCCGCCGATGAA
ATAATATCGCCCAAAGAAT -> TAATATCGCCCAAAGAATA
ATAATCTAGATACTTTGGT -> TAATCTAGATACTTTGGTA
ATAATGCCATTTGGCTAAG -> TAATGCCATTTGGCTAAGC
ATAATTCACAGGAGTAGAC -> TAATTCACAGGAGTAGACA
ATAATTGTCTGCATCTGAC -> TAATTGTCTGCATCTGACG
ATACAGTCTGATGCGTAGC -> TACAGTCTGATGCGTAGCA
ATACATGAGTGTTCCATAA -> TACATGAGTGTTCCATAAT
ATACGAGAACACTAGCATA -> TACGAGAACACTAGCATAG
ATACTCATGGCGAGACTAT -> TACTCATGGCGAGACTATC
ATACTCCCTCTGAGTGTGG -> TACTCCCTCTGAGTGTGGC
ATACTGCGCGTTGTTCGGA -> TACTGCGCGTTGTTCGGAT
ATACTTCATGTCGATCTAC -> TACTTCATGTCGATCTACT
ATACTTTGGTATCATCTCA -> TACTTTGGTATCATCTCAC
ATAGAGGGCCAGTACGCAG -> TAGAGGGCCAGTACGCAGA
ATAGATAACTGATGCCAGA -> TAGATAACTGATGCCAGAT
ATAGCGACATTTAGCAGAC -> TAGCGACATTTAGCAGACC
ATAGGCCAGAACGATGTTC -> TAGGCCAGAACGATGTTCG
ATAGGCCTCTAGTCTTTTA -> TAGGCCTCTAGTCTTTTAC
ATAGGTGACACGGTAGATT -> TAGGTGACACGGTAGATTA
ATAGGTTACTCTGCTTATC -> TAGGTTACTCTGCTTATCG
ATAGTCCGTAAGATTTGAC -> TAGTCCGTAAGATTTGACA
ATAGTGCCCGCCTCGAGCA -> TAGTGCCCGCCTCGAGCAG
ATAGTGCTCGTCGTGCTCA -> TAGTGCTCGTCGTGCTCAG
ATAGTTACTCAGTTTAAAC -> TAGTTACTCAGTTTAAACT
ATATAGAGGGCCAGTACGC -> TATAGAGGGCCAGTACGCA
ATATAGGCCTCTAGTCTTT -> TATAGGCCTCTAGTCTTTT
ATATCGCCCAAAGAATAAC -> TATCGCCCAAAGAATAACG
ATATCGTCATACTGCGCGT -> TATCGTCATACTGCGCGTT
ATATTGACCAATTTGTTCC -> TATTGACCAATTTGTTCCA
ATCAACCAAAGCACCCGCA -> TCAACCAAAGCACCCGCAC
ATCAATTGAGTCCCCCTCC -> TCAATTGAGTCCCCCTCCT
ATCAGCTTTCCGAGGCTCC -> TCAGCTTTCCGAGGCTCCG
ATCAGTTAAGGTTACGTTG -> TCAGTTAAGGTTACGTTGA
ATCATCTCACAATGTATGA -> TCATCTCACAATGTATGAG
ATCATTGACAGATGGCAGT -> TCATTGACAGATGGCAGTA
ATCCCCGTATAATGCCATT -> TCCCCGTATAATGCCATTT
ATCCCGGGGAGGTGCTCCG -> TCCCGGGGAGGTGCTCCGT
ATCCTATTCAATGAGCGCC -> TCCTATTCAATGAGCGCCC
ATCCTCAACGGCTGTACAT -> TCCTCAACGGCTGTACATC
ATCCTGGCTGCGTACTGGT -> TCCTGGCTGCGTACTGGTG
ATCGCCCAAAGAATAACGC -> TCGCCCAAAGAATAACGCG
ATCGCCGATAGTCCGTAAG -> TCGCCGATAGTCCGTAAGA
ATCGGGATCTTATCAATTG -> TCGGGATCTTATCAATTGA
ATCGTAAAACCACGGAAGG -> TCGTAAAACCACGGAAGGA
ATCGTAGCCGGTAGCACGA -> TCGTAGCCGGTAGCACGAC
ATCGTCATACTGCGCGTTG -> TCGTCATACTGCGCGTTGT
ATCGTCGCTCGCCGAGCAG -> TCGTCGCTCGCCGAGCAGT
ATCGTCGTGCTCAGTATGA -> TCGTCGTGCTCAGTATGAA
ATCGTGGACGAAATTATAC -> TCGTGGACGAAATTATACA
ATCTACTGACGGCTAGCTT -> TCTACTGACGGCTAGCTTT
ATCTAGATACTTTGGTATC -> TCTAGATACTTTGGTATCA
ATCTCACAATGTATGAGCC -> TCTCACAATGTATGAGCCA
ATCTCTTTACGCAGTACTC -> TCTCTTTACGCAGTACTCC
ATCTGACGCTGGTCGCTGG -> TCTGACGCTGGTCGCTGGG
ATCTGTTGAGCTGCGGAAT -> TCTGTTGAGCTGCGGAATA
ATCTTATCAATTGAGTCCC -> TCTTATCAATTGAGTCCCC
ATGAAGAGCCTTACGATTC -> TGAAGAGCCTTACGATTCG
ATGAAGATCAGTTAAGGTT -> TGAAGATCAGTTAAGGTTA
ATGAAGATGAGTGTGAAAA -> TGAAGATGAGTGTGAAAAG
ATGAAGGACGTGGCGGCCG -> TGAAGGACGTGGCGGCCGA
ATGAAGGGACAGAACACGA -> TGAAGGGACAGAACACGAT
ATGAAGTAAAATGCCCCGG -> TGAAGTAAAATGCCCCGGT
ATGAATAATCTAGATACTT -> TGAATAATCTAGATACTTT
ATGACGAGAATGATCCTCA -> TGACGAGAATGATCCTCAA
ATGAGCCATGCCCCGGTAC -> TGAGCCATGCCCCGGTACT
ATGAGCGCCCGATAGGTTA -> TGAGCGCCCGATAGGTTAC
ATGAGTGTGAAAAGTGAGA -> TGAGTGTGAAAAGTGAGAC
ATGAGTGTTCCATAATTGT -> TGAGTGTTCCATAATTGTC
ATGATAATTCACAGGAGTA -> TGATAATTCACAGGAGTAG
ATGATCCTCAACGGCTGTA -> TGATCCTCAACGGCTGTAC
ATGCAATGATAATTCACAG -> TGCAATGATAATTCACAGG
ATGCAGGGCGCGTGAGTGT -> TGCAGGGCGCGTGAGTGTG
ATGCCAGATTATAACCCTA -> TGCCAGATTATAACCCTAC
ATGCCATTTGGCTAAGCCC -> TGCCATTTGGCTAAGCCCG
ATGCCCCGGTACTCTGTTG -> TGCCCCGGTACTCTGTTGG
ATGCCCCGGTCTTAGGGGA -> TGCCCCGGTCTTAGGGGAT
ATGCGTAGCAGAGCAGTTC -> TGCGTAGCAGAGCAGTTCA
ATGGAAAGTGAGACACAAG -> TGGAAAGTGAGACACAAGC
ATGGCAGTAAGAGTACACA -> TGGCAGTAAGAGTACACAC
ATGGCGAGACTATCCCCGT -> TGGCGAGACTATCCCCGTA
ATGGTTAAAATCGTCGCTC -> TGGTTAAAATCGTCGCTCG
ATGTACAGCGCGTCGTCGT -> TGTACAGCGCGTCGTCGTG
ATGTACTGTGGCGAGTAAT -> TGTACTGTGGCGAGTAATA
ATGTATGAGCCATGCCCCG -> TGTATGAGCCATGCCCCGG
ATGTCGATCTACTGACGGC -> TGTCGATCTACTGACGGCT
ATGTCGGGTCTTGAATAAA -> TGTCGGGTCTTGAATAAAG
ATGTTCGAAGAACGATAGT -> TGTTCGAAGAACGATAGTG
ATTAAAAATACAGTCTGAT -> TTAAAAATACAGTCTGATG
ATTACACTACAAAAGAAAT -> TTACACTACAAAAGAAATT
ATTACAGTCTATACTTCAT -> TTACAGTCTATACTTCATG
ATTACATCATTGACAGATG -> TTACATCATTGACAGATGG
ATTACCAGCGCCTCGACAT -> TTACCAGCGCCTCGACATG
ATTAGATAAAGGCGGATTA -> TTAGATAAAGGCGGATTAT
ATTAGCATCGTAGCCGGTA -> TTAGCATCGTAGCCGGTAG
ATTATAACCCTACCTCCGG -> TTATAACCCTACCTCCGGT
ATTATACATGAGTGTTCCA -> TTATACATGAGTGTTCCAT
ATTATTTGTCACAATTACC -> TTATTTGTCACAATTACCA
ATTCAATGAGCGCCCGATA -> TTCAATGAGCGCCCGATAG
ATTCACAGGAGTAGACACC -> TTCACAGGAGTAGACACCA
ATTCCACATTAGATAAAGG -> TTCCACATTAGATAAAGGC
ATTCCATTGCGACTAGTCA -> TTCCATTGCGACTAGTCAC
ATTCCGCTTTCATCTGTTG -> TTCCGCTTTCATCTGTTGA
ATTCGACAAGATGACGAGA -> TTCGACAAGATGACGAGAA
ATTCGGTGTACCCTTTTGG -> TTCGGTGTACCCTTTTGGC
ATTCTGTCACTGACTCTTT -> TTCTGTCACTGACTCTTTG
ATTCTTGTCTCAAGCACAC -> TTCTTGTCTCAAGCACACA
ATTGACAGATGGCAGTAAG -> TTGACAGATGGCAGTAAGA
ATTGACCAATTTGTTCCAA -> TTGACCAATTTGTTCCAAC
ATTGAGTCCCCCTCCTAAT -> TTGAGTCCCCCTCCTAATC
ATTGCGACTAGTCACAACT -> TTGCGACTAGTCACAACTA
ATTGCGGTTGGGGAGAAGG -> TTGCGGTTGGGGAGAAGGG
ATTGCTGGTTCCAAAAACC -> TTGCTGGTTCCAAAAACCG
ATTGGCACACTGCTACTCG -> TTGGCACACTGCTACTCGG
ATTGTCTGCATCTGACGCT -> TTGTCTGCATCTGACGCTG
ATTGTTATAGGCCAGAACG -> TTGTTATAGGCCAGAACGA
ATTTACCCTTAATTTGATA -> TTTACCCTTAATTTGATAT
ATTTAGCAGACCCCCGCAA -> TTTAGCAGACCCCCGCAAC
ATTTAGCTTCAAACAAGTT -> TTTAGCTTCAAACAAGTTT
ATTTCAACCTGTGATCGTA -> TTTCAACCTGTGATCGTAA
ATTTGACAGCTCCTAGAAG -> TTTGACAGCTCCTAGAAGT
ATTTGATATCGTCATACTG -> TTTGATATCGTCATACTGC
ATTTGCAGGTCAATAAGGT -> TTTGCAGGTCAATAAGGTT
ATTTGGCGTGAGCGACCTA -> TTTGGCGTGAGCGACCTAT
ATTTGGCTAAGCCCGGCCT -> TTTGGCTAAGCCCGGCCTT
ATTTGTCACAATTACCAGC -> TTTGTCACAATTACCAGCG
ATTTGTTCCAACCTGCGGC -> TTTGTTCCAACCTGCGGCG
ATTTTCCCTACCCCAACAT -> TTTTCCCTACCCCAACATA
CAAAAACCGTTTTATTGTT -> AAAAACCGTTTTATTGTTA
CAAAAGAAATTTGGCGTGA -> AAAAGAAATTTGGCGTGAG
CAAACAAGTTTATTCGGTG -> AAACAAGTTTATTCGGTGT
CAAACAGTCCTATAATAAC -> AAACAGTCCTATAATAACT
CAAACGAGGTGGCCCCCTG -> AAACGAGGTGGCCCCCTGT
CAAACGCCAGGGCATCTCT -> AAACGCCAGGGCATCTCTT
CAAACGGGGTCCTTAGTGA -> AAACGGGGTCCTTAGTGAA
CAAAGAATAACGCGGCTGT -> AAAGAATAACGCGGCTGTT
CAAAGCACCCGCACTACAC -> AAAGCACCCGCACTACACT
CAAAGTGAGACACAAGCTA -> AAAGTGAGACACAAGCTAC
CAAATCGCCGATAGTCCGT -> AAATCGCCGATAGTCCGTA
CAACATAGTTACTCAGTTT -> AACATAGTTACTCAGTTTA
CAACCAAAGCACCCGCACT -> AACCAAAGCACCCGCACTA
CAACCCACTAAGGGACCGT -> AACCCACTAAGGGACCGTA
CAACCTGCGGCGACTACTG -> AACCTGCGGCGACTACTGG
CAACCTGTGATCGTAAAAC -> AACCTGTGATCGTAAAACC
CAACCTTCAAGATTAAAAA -> AACCTTCAAGATTAAAAAT
CAACGGCTGTACATCCCGG -> AACGGCTGTACATCCCGGG
CAACTACGCGGTCTGAAGG -> AACTACGCGGTCTGAAGGA
CAACTGCATAAATTCTGTC -> AACTGCATAAATTCTGTCA
CAAGATGACGAGAATGATC -> AAGATGACGAGAATGATCC
CAAGATTAAAAATACAGTC -> AAGATTAAAAATACAGTCT
CAAGCACACACCAAACGAG -> AAGCACACACCAAACGAGG
CAAGCTAAGCTAGGAGTTT -> AAGCTAAGCTAGGAGTTTC
CAAGCTACCACTTTGCGAT -> AAGCTACCACTTTGCGATC
CAAGCTAGGGCATAGTGCT -> AAGCTAGGGCATAGTGCTC
CAAGCTATGTACAGCGCGT -> AAGCTATGTACAGCGCGTC
CAAGTTTATTCGGTGTACC -> AAGTTTATTCGGTGTACCC
CAATAAGGTTTATGAAGAT -> AATAAGGTTTATGAAGATG
CAATACGAGAACACTAGCA -> AATACGAGAACACTAGCAT
CAATGAGCGCCCGATAGGT -> AATGAGCGCCCGATAGGTT
CAATGATAATTCACAGGAG -> AATGATAATTCACAGGAGT
CAATGTATGAGCCATGCCC -> AATGTATGAGCCATGCCCC
CAATTACCAGCGCCTCGAC -> AATTACCAGCGCCTCGACA
CAATTGAGTCCCCCTCCTA -> AATTGAGTCCCCCTCCTAA
CAATTGCTGGTTCCAAAAA -> AATTGCTGGTTCCAAAAAC
CAATTTGCAGGTCAATAAG -> AATTTGCAGGTCAATAAGG
CAATTTGTTCCAACCTGCG -> AATTTGTTCCAACCTGCGG
CACAACTACGCGGTCTGAA -> ACAACTACGCGGTCTGAAG
CACAAGCTAAGCTAGGAGT -> ACAAGCTAAGCTAGGAGTT
CACAAGCTACCACTTTGCG -> ACAAGCTACCACTTTGCGA
CACAAGCTAGGGCATAGTG -> ACAAGCTAGGGCATAGTGC
CACAAGCTATGTACAGCGC -> ACAAGCTATGTACAGCGCG
CACAATGTATGAGCCATGC -> ACAATGTATGAGCCATGCC
CACAATTACCAGCGCCTCG -> ACAATTACCAGCGCCTCGA
CACACACCAAACGAGGTGG -> ACACACCAAACGAGGTGGC
CACACAGTGTTAATTTCAA -> ACACAGTGTTAATTTCAAC
CACACCAAACGAGGTGGCC -> ACACCAAACGAGGTGGCCC
CACACTGCTACTCGGAGGT -> ACACTGCTACTCGGAGGTT
CACAGGAGTAGACACCAAC -> ACAGGAGTAGACACCAACC
CACAGTGTTAATTTCAACC -> ACAGTGTTAATTTCAACCT
CACATTAGATAAAGGCGGA -> ACATTAGATAAAGGCGGAT
CACCAAACGAGGTGGCCCC -> ACCAAACGAGGTGGCCCCC
CACCAACCCACTAAGGGAC -> ACCAACCCACTAAGGGACC
CACCCGCACTACACTTGTA -> ACCCGCACTACACTTGTAC
CACCTTCTCATTGCGGTTG -> ACCTTCTCATTGCGGTTGG
CACGACCTCCAAATCGCCG -> ACGACCTCCAAATCGCCGA
CACGATTCCACATTAGATA -> ACGATTCCACATTAGATAA
CACGGAAGGACCGGAGTGA -> ACGGAAGGACCGGAGTGAA
CACGGTAGATTACACTACA -> ACGGTAGATTACACTACAA
CACTAAGGGACCGTATAAT -> ACTAAGGGACCGTATAATA
CACTACAAAAGAAATTTGG -> ACTACAAAAGAAATTTGGC
CACTACACTTGTACGGTGA -> ACTACACTTGTACGGTGAT
CACTAGCATAGCGACATTT -> ACTAGCATAGCGACATTTA
CACTAGTTAACCCTACCGT -> ACTAGTTAACCCTACCGTT
CACTCCCAACTGCATAAAT -> ACTCCCAACTGCATAAATT
CACTGACTCTTTGTCGCGG -> ACTGACTCTTTGTCGCGGT
CACTGCTACTCGGAGGTTA -> ACTGCTACTCGGAGGTTAT
CACTTGTACGGTGATGCAG -> ACTTGTACGGTGATGCAGG
CACTTTGCGATCGTCGTGC -> ACTTTGCGATCGTCGTGCT
CAGAACACGATTCCACATT -> AGAACACGATTCCACATTA
CAGAACGATGTTCGAAGAA -> AGAACGATGTTCGAAGAAC
CAGACCCCCGCAACCTTCA -> AGACCCCCGCAACCTTCAA
CAGACCCGTAACGATTTAG -> AGACCCGTAACGATTTAGC
CAGACTTTCCCTTCGAGCT -> AGACTTTCCCTTCGAGCTA
CAGAGCAGTTCATGGAAAG -> AGAGCAGTTCATGGAAAGT
CAGATGGCAGTAAGAGTAC -> AGATGGCAGTAAGAGTACA
CAGATTATAACCCTACCTC -> AGATTATAACCCTACCTCC
CAGCAAACGGGGTCCTTAG -> AGCAAACGGGGTCCTTAGT
CAGCGACAAAGTGAGACAC -> AGCGACAAAGTGAGACACA
CAGCGCCTCGACATGAAGA -> AGCGCCTCGACATGAAGAT
CAGCGCGTCGTCGTGCTCA -> AGCGCGTCGTCGTGCTCAG
CAGCTCCTAGAAGTGAGGC -> AGCTCCTAGAAGTGAGGCA
CAGCTTTCCGAGGCTCCGA -> AGCTTTCCGAGGCTCCGAT
CAGGAGTAGACACCAACCC -> AGGAGTAGACACCAACCCA
CAGGCGACTCGTACCTGCG -> AGGCGACTCGTACCTGCGA
CAGGGCACCTTCTCATTGC -> AGGGCACCTTCTCATTGCG
CAGGGCATCTCTTTACGCA -> AGGGCATCTCTTTACGCAG
CAGGGCGCGTGAGTGTGCA -> AGGGCGCGTGAGTGTGCAA
CAGGTCAATAAGGTTTATG -> AGGTCAATAAGGTTTATGA
CAGGTCGAACTACTTAATT -> AGGTCGAACTACTTAATTT
CAGGTCTGCCGCTTTCTTC -> AGGTCTGCCGCTTTCTTCT
CAGTAAGAGTACACACAGT -> AGTAAGAGTACACACAGTG
CAGTACGCAGACTTTCCCT -> AGTACGCAGACTTTCCCTT
CAGTACTCCGCCCGATGTC -> AGTACTCCGCCCGATGTCG
CAGTATGAAGAGCCTTACG -> AGTATGAAGAGCCTTACGA
CAGTATGAAGGACGTGGCG -> AGTATGAAGGACGTGGCGG
CAGTATGAAGGGACAGAAC -> AGTATGAAGGGACAGAACA
CAGTATGAATAATCTAGAT -> AGTATGAATAATCTAGATA
CAGTCCTATAATAACTCCG -> AGTCCTATAATAACTCCGC
CAGTCTATACTTCATGTCG -> AGTCTATACTTCATGTCGA
CAGTCTGATGCGTAGCAGA -> AGTCTGATGCGTAGCAGAG
CAGTGTAGCTCGACACTCC -> AGTGTAGCTCGACACTCCC
CAGTGTTAATTTCAACCTG -> AGTGTTAATTTCAACCTGT
CAGTTAAGGTTACGTTGAA -> AGTTAAGGTTACGTTGAAG
CAGTTCATGGAAAGTGAGA -> AGTTCATGGAAAGTGAGAC
CAGTTTAAACTGCTACCAT -> AGTTTAAACTGCTACCATC
CATAAATTCTGTCACTGAC -> ATAAATTCTGTCACTGACT
CATAATTGTCTGCATCTGA -> ATAATTGTCTGCATCTGAC
CATACTGCGCGTTGTTCGG -> ATACTGCGCGTTGTTCGGA
CATAGCGACATTTAGCAGA -> ATAGCGACATTTAGCAGAC
CATAGTGCTCGTCGTGCTC -> ATAGTGCTCGTCGTGCTCA
CATAGTTACTCAGTTTAAA -> ATAGTTACTCAGTTTAAAC
CATATTGACCAATTTGTTC -> ATATTGACCAATTTGTTCC
CATCAGCTTTCCGAGGCTC -> ATCAGCTTTCCGAGGCTCC
CATCATTGACAGATGGCAG -> ATCATTGACAGATGGCAGT
CATCCCGGGGAGGTGCTCC -> ATCCCGGGGAGGTGCTCCG
CATCGGGATCTTATCAATT -> ATCGGGATCTTATCAATTG
CATCGTAGCCGGTAGCACG -> ATCGTAGCCGGTAGCACGA
CATCTCACAATGTATGAGC -> ATCTCACAATGTATGAGCC
CATCTCTTTACGCAGTACT -> ATCTCTTTACGCAGTACTC
CATCTGACGCTGGTCGCTG -> ATCTGACGCTGGTCGCTGG
CATCTGTTGAGCTGCGGAA -> ATCTGTTGAGCTGCGGAAT
CATGAAGATCAGTTAAGGT -> ATGAAGATCAGTTAAGGTT
CATGAGTGTTCCATAATTG -> ATGAGTGTTCCATAATTGT
CATGCCCCGGTACTCTGTT -> ATGCCCCGGTACTCTGTTG
CATGGAAAGTGAGACACAA -> ATGGAAAGTGAGACACAAG
CATGGCGAGACTATCCCCG -> ATGGCGAGACTATCCCCGT
CATGGTTAAAATCGTCGCT -> ATGGTTAAAATCGTCGCTC
CATGTCGATCTACTGACGG -> ATGTCGATCTACTGACGGC
CATTAGATAAAGGCGGATT -> ATTAGATAAAGGCGGATTA
CATTGACAGATGGCAGTAA -> ATTGACAGATGGCAGTAAG
CATTGCGACTAGTCACAAC -> ATTGCGACTAGTCACAACT
CATTGCGGTTGGGGAGAAG -> ATTGCGGTTGGGGAGAAGG
CATTTAGCAGACCCCCGCA -> ATTTAGCAGACCCCCGCAA
CATTTGGCTAAGCCCGGCC -> ATTTGGCTAAGCCCGGCCT
CCAAAAACCGTTTTATTGT -> CAAAAACCGTTTTATTGTT
CCAAACGAGGTGGCCCCCT -> CAAACGAGGTGGCCCCCTG
CCAAACGCCAGGGCATCTC -> CAAACGCCAGGGCATCTCT
CCAAAGAATAACGCGGCTG -> CAAAGAATAACGCGGCTGT
CCAAAGCACCCGCACTACA -> CAAAGCACCCGCACTACAC
CCAAATCGCCGATAGTCCG -> CAAATCGCCGATAGTCCGT
CCAACATAGTTACTCAGTT -> CAACATAGTTACTCAGTTT
CCAACCCACTAAGGGACCG -> CAACCCACTAAGGGACCGT
CCAACCTGCGGCGACTACT -> CAACCTGCGGCGACTACTG
CCAACTGCATAAATTCTGT -> CAACTGCATAAATTCTGTC
CCAATTTGCAGGTCAATAA -> CAATTTGCAGGTCAATAAG
CCAATTTGTTCCAACCTGC -> CAATTTGTTCCAACCTGCG
CCACATTAGATAAAGGCGG -> CACATTAGATAAAGGCGGA
CCACGGAAGGACCGGAGTG -> CACGGAAGGACCGGAGTGA
CCACTAAGGGACCGTATAA -> CACTAAGGGACCGTATAAT
CCACTTTGCGATCGTCGTG -> CACTTTGCGATCGTCGTGC
CCAGAACGATGTTCGAAGA -> CAGAACGATGTTCGAAGAA
CCAGATTATAACCCTACCT -> CAGATTATAACCCTACCTC
CCAGCGCCTCGACATGAAG -> CAGCGCCTCGACATGAAGA
CCAGGGCACCTTCTCATTG -> CAGGGCACCTTCTCATTGC
CCAGGGCATCTCTTTACGC -> CAGGGCATCTCTTTACGCA
CCAGTACGCAGACTTTCCC -> CAGTACGCAGACTTTCCCT
CCATAATTGTCTGCATCTG -> CATAATTGTCTGCATCTGA
CCATATTGACCAATTTGTT -> CATATTGACCAATTTGTTC
CCATCAGCTTTCCGAGGCT -> CATCAGCTTTCCGAGGCTC
CCATCGGGATCTTATCAAT -> CATCGGGATCTTATCAATT
CCATGCCCCGGTACTCTGT -> CATGCCCCGGTACTCTGTT
CCATTGCGACTAGTCACAA -> CATTGCGACTAGTCACAAC
CCATTTGGCTAAGCCCGGC -> CATTTGGCTAAGCCCGGCC
CCCAAAGAATAACGCGGCT -> CCAAAGAATAACGCGGCTG
CCCAACATAGTTACTCAGT -> CCAACATAGTTACTCAGTT
CCCAACTGCATAAATTCTG -> CCAACTGCATAAATTCTGT
CCCACTAAGGGACCGTATA -> CCACTAAGGGACCGTATAA
CCCCAACATAGTTACTCAG -> CCCAACATAGTTACTCAGT
CCCCCGCAACCTTCAAGAT -> CCCCGCAACCTTCAAGATT
CCCCCTCCTAATCCTATTC -> CCCCTCCTAATCCTATTCA
CCCCCTGTCTGTAAGCAAT -> CCCCTGTCTGTAAGCAATT
CCCCGCAACCTTCAAGATT -> CCCGCAACCTTCAAGATTA
CCCCGGTACTCTGTTGGGT -> CCCGGTACTCTGTTGGGTA
CCCCGGTCTTAGGGGATAA -> CCCGGTCTTAGGGGATAAC
CCCCGTATAATGCCATTTG -> CCCGTATAATGCCATTTGG
CCCCTCCTAATCCTATTCA -> CCCTCCTAATCCTATTCAA
CCCCTGTCTGTAAGCAATT -> CCCTGTCTGTAAGCAATTG
CCCGAATTCCATTGCGACT -> CCGAATTCCATTGCGACTA
CCCGATAGGTTACTCTGCT -> CCGATAGGTTACTCTGCTT
CCCGATGTCGGGTCTTGAA -> CCGATGTCGGGTCTTGAAT
CCCGCAACCTTCAAGATTA -> CCGCAACCTTCAAGATTAA
CCCGCACTACACTTGTACG -> CCGCACTACACTTGTACGG
CCCGCCTCGAGCAGGTCTG -> CCGCCTCGAGCAGGTCTGC
CCCGGCCTTATTACATCAT -> CCGGCCTTATTACATCATT
CCCGGGGAGGTGCTCCGTT -> CCGGGGAGGTGCTCCGTTC
CCCGGTACTCTGTTGGGTA -> CCGGTACTCTGTTGGGTAG
CCCGGTCTTAGGGGATAAC -> CCGGTCTTAGGGGATAACG
CCCGTAACGATTTAGCTTC -> CCGTAACGATTTAGCTTCA
CCCGTATAATGCCATTTGG -> CCGTATAATGCCATTTGGC
CCCTACCCCAACATAGTTA -> CCTACCCCAACATAGTTAC
CCCTACCGTTCTGTGGCTC -> CCTACCGTTCTGTGGCTCG
CCCTACCTCCGGTAGAATT -> CCTACCTCCGGTAGAATTG
CCCTAGTGAGTATTCTTGT -> CCTAGTGAGTATTCTTGTC
CCCTCCTAATCCTATTCAA -> CCTCCTAATCCTATTCAAT
CCCTCTGAGTGTGGCTCAG -> CCTCTGAGTGTGGCTCAGC
CCCTGTCTGTAAGCAATTG -> CCTGTCTGTAAGCAATTGC
CCCTTAATTTGATATCGTC -> CCTTAATTTGATATCGTCA
CCCTTCGAGCTACCATCAG -> CCTTCGAGCTACCATCAGC
CCCTTTTGGCAGCGACAAA -> CCTTTTGGCAGCGACAAAG
CCGAATTCCATTGCGACTA -> CGAATTCCATTGCGACTAG
CCGAGCAGTGTAGCTCGAC -> CGAGCAGTGTAGCTCGACA
CCGAGGCTCCGATTAGCAT -> CGAGGCTCCGATTAGCATC
CCGATAGGTTACTCTGCTT -> CGATAGGTTACTCTGCTTA
CCGATAGTCCGTAAGATTT -> CGATAGTCCGTAAGATTTG
CCGATGAAGTAAAATGCCC -> CGATGAAGTAAAATGCCCC
CCGATGTCGGGTCTTGAAT -> CGATGTCGGGTCTTGAATA
CCGATTAGCATCGTAGCCG -> CGATTAGCATCGTAGCCGG
CCGATTCCGCTTTCATCTG -> CGATTCCGCTTTCATCTGT
CCGCAACCTTCAAGATTAA -> CGCAACCTTCAAGATTAAA
CCGCACTACACTTGTACGG -> CGCACTACACTTGTACGGT
CCGCCCGATGTCGGGTCTT -> CGCCCGATGTCGGGTCTTG
CCGCCGATGAAGTAAAATG -> CGCCGATGAAGTAAAATGC
CCGCCTCGAGCAGGTCTGC -> CGCCTCGAGCAGGTCTGCC
CCGCTCCTTGGTACCTATC -> CGCTCCTTGGTACCTATCC
CCGCTTTCATCTGTTGAGC -> CGCTTTCATCTGTTGAGCT
CCGCTTTCTTCTGGTGAAT -> CGCTTTCTTCTGGTGAATA
CCGGAGTGAAAGAACGAAA -> CGGAGTGAAAGAACGAAAC
CCGGCCTTATTACATCATT -> CGGCCTTATTACATCATTG
CCGGGGAGGTGCTCCGTTC -> CGGGGAGGTGCTCCGTTCG
CCGGTACTCTGTTGGGTAG -> CGGTACTCTGTTGGGTAGA
CCGGTAGAATTGGCACACT -> CGGTAGAATTGGCACACTG
CCGGTAGCACGACCTCCAA -> CGGTAGCACGACCTCCAAA
CCGGTCTTAGGGGATAACG -> CGGTCTTAGGGGATAACGT
CCGGTGATCAACCAAAGCA -> CGGTGATCAACCAAAGCAC
CCGTAACGATTTAGCTTCA -> CGTAACGATTTAGCTTCAA
CCGTAAGATTTGACAGCTC -> CGTAAGATTTGACAGCTCC
CCGTATAATATCGCCCAAA -> CGTATAATATCGCCCAAAG
CCGTATAATGCCATTTGGC -> CGTATAATGCCATTTGGCT
CCGTTCGTTTGACTGGCCG -> CGTTCGTTTGACTGGCCGC
CCGTTCTGTGGCTCGACAG -> CGTTCTGTGGCTCGACAGG
CCGTTTTATTGTTATAGGC -> CGTTTTATTGTTATAGGCC
CCTAATCCTATTCAATGAG -> CTAATCCTATTCAATGAGC
CCTACCCCAACATAGTTAC -> CTACCCCAACATAGTTACT
CCTACCGTTCTGTGGCTCG -> CTACCGTTCTGTGGCTCGA
CCTACCTCCGGTAGAATTG -> CTACCTCCGGTAGAATTGG
CCTAGAAGTGAGGCAGGTC -> CTAGAAGTGAGGCAGGTCG
CCTAGGCAGACCCGTAACG -> CTAGGCAGACCCGTAACGA
CCTAGTGAGTATTCTTGTC -> CTAGTGAGTATTCTTGTCT
CCTATAATAACTCCGCCGA -> CTATAATAACTCCGCCGAT
CCTATACTCATGGCGAGAC -> CTATACTCATGGCGAGACT
CCTATCCTGGCTGCGTACT -> CTATCCTGGCTGCGTACTG
CCTATTCAATGAGCGCCCG -> CTATTCAATGAGCGCCCGA
CCTCAACGGCTGTACATCC -> CTCAACGGCTGTACATCCC
CCTCCAAATCGCCGATAGT -> CTCCAAATCGCCGATAGTC
CCTCCGGTAGAATTGGCAC -> CTCCGGTAGAATTGGCACA
CCTCCTAATCCTATTCAAT -> CTCCTAATCCTATTCAATG
CCTCGACATGAAGATCAGT -> CTCGACATGAAGATCAGTT
CCTCGAGCAGGTCTGCCGC -> CTCGAGCAGGTCTGCCGCT
CCTCTAGTCTTTTACCCGA -> CTCTAGTCTTTTACCCGAA
CCTCTGAGTGTGGCTCAGC -> CTCTGAGTGTGGCTCAGCA
CCTGCGAAGTACCAAACGC -> CTGCGAAGTACCAAACGCC
CCTGCGGCGACTACTGGGG -> CTGCGGCGACTACTGGGGG
CCTGGCTGCGTACTGGTGC -> CTGGCTGCGTACTGGTGCT
CCTGTCTGTAAGCAATTGC -> CTGTCTGTAAGCAATTGCT
CCTGTGATCGTAAAACCAC -> CTGTGATCGTAAAACCACG
CCTTAATTTGATATCGTCA -> CTTAATTTGATATCGTCAT
CCTTACGATTCGACAAGAT -> CTTACGATTCGACAAGATG
CCTTAGTGAAAGATCGTGG -> CTTAGTGAAAGATCGTGGA
CCTTATTACATCATTGACA -> CTTATTACATCATTGACAG
CCTTCAAGATTAAAAATAC -> CTTCAAGATTAAAAATACA
CCTTCGAGCTACCATCAGC -> CTTCGAGCTACCATCAGCT
CCTTCTCATTGCGGTTGGG -> CTTCTCATTGCGGTTGGGG
CCTTGGTACCTATCCTGGC -> CTTGGTACCTATCCTGGCT
CCTTTTGGCAGCGACAAAG -> CTTTTGGCAGCGACAAAGT
CGAAACTCGCCGGTGATCA -> GAAACTCGCCGGTGATCAA
CGAAATTATACATGAGTGT -> GAAATTATACATGAGTGTT
CGAACTACTTAATTTTCCC -> GAACTACTTAATTTTCCCT
CGAAGAACGATAGTGCCCG -> GAAGAACGATAGTGCCCGC
CGAAGTACCAAACGCCAGG -> GAAGTACCAAACGCCAGGG
CGAATTCCATTGCGACTAG -> GAATTCCATTGCGACTAGT
CGACAAAGTGAGACACAAG -> GACAAAGTGAGACACAAGC
CGACAAGATGACGAGAATG -> GACAAGATGACGAGAATGA
CGACACTCCCAACTGCATA -> GACACTCCCAACTGCATAA
CGACAGGCGACTCGTACCT -> GACAGGCGACTCGTACCTG
CGACATGAAGATCAGTTAA -> GACATGAAGATCAGTTAAG
CGACATTTAGCAGACCCCC -> GACATTTAGCAGACCCCCG
CGACCTATACTCATGGCGA -> GACCTATACTCATGGCGAG
CGACCTCCAAATCGCCGAT -> GACCTCCAAATCGCCGATA
CGACTACTGGGGGTGGTAA -> GACTACTGGGGGTGGTAAT
CGACTAGTCACAACTACGC -> GACTAGTCACAACTACGCG
CGACTCGTACCTGCGAAGT -> GACTCGTACCTGCGAAGTA
CGAGAACACTAGCATAGCG -> GAGAACACTAGCATAGCGA
CGAGAATGATCCTCAACGG -> GAGAATGATCCTCAACGGC
CGAGACTATCCCCGTATAA -> GAGACTATCCCCGTATAAT
CGAGCAGGTCTGCCGCTTT -> GAGCAGGTCTGCCGCTTTC
CGAGCAGTGTAGCTCGACA -> GAGCAGTGTAGCTCGACAC
CGAGCTACCATCAGCTTTC -> GAGCTACCATCAGCTTTCC
CGAGGCTCCGATTAGCATC -> GAGGCTCCGATTAGCATCG
CGAGGTGGCCCCCTGTCTG -> GAGGTGGCCCCCTGTCTGT
CGAGTAATAGATAACTGAT -> GAGTAATAGATAACTGATG
CGAGTATTACAGTCTATAC -> GAGTATTACAGTCTATACT
CGATAGGTGACACGGTAGA -> GATAGGTGACACGGTAGAT
CGATAGGTTACTCTGCTTA -> GATAGGTTACTCTGCTTAT
CGATAGTCCGTAAGATTTG -> GATAGTCCGTAAGATTTGA
CGATAGTGCCCGCCTCGAG -> GATAGTGCCCGCCTCGAGC
CGATCGTCGTGCTCAGTAT -> GATCGTCGTGCTCAGTATG
CGATCTACTGACGGCTAGC -> GATCTACTGACGGCTAGCT
CGATGAAGTAAAATGCCCC -> GATGAAGTAAAATGCCCCG
CGATGTCGGGTCTTGAATA -> GATGTCGGGTCTTGAATAA
CGATGTTCGAAGAACGATA -> GATGTTCGAAGAACGATAG
CGATTAGCATCGTAGCCGG -> GATTAGCATCGTAGCCGGT
CGATTCCACATTAGATAAA -> GATTCCACATTAGATAAAG
CGATTCCGCTTTCATCTGT -> GATTCCGCTTTCATCTGTT
CGATTCGACAAGATGACGA -> GATTCGACAAGATGACGAG
CGATTTAGCTTCAAACAAG -> GATTTAGCTTCAAACAAGT
CGCAACCTTCAAGATTAAA -> GCAACCTTCAAGATTAAAA
CGCACTACACTTGTACGGT -> GCACTACACTTGTACGGTG
CGCAGACTTTCCCTTCGAG -> GCAGACTTTCCCTTCGAGC
CGCAGTACTCCGCCCGATG -> GCAGTACTCCGCCCGATGT
CGCCAGGGCATCTCTTTAC -> GCCAGGGCATCTCTTTACG
CGCCCAAAGAATAACGCGG -> GCCCAAAGAATAACGCGGC
CGCCCGATAGGTTACTCTG -> GCCCGATAGGTTACTCTGC
CGCCCGATGTCGGGTCTTG -> GCCCGATGTCGGGTCTTGA
CGCCGAGCAGTGTAGCTCG -> GCCGAGCAGTGTAGCTCGA
CGCCGATAGTCCGTAAGAT -> GCCGATAGTCCGTAAGATT
CGCCGATGAAGTAAAATGC -> GCCGATGAAGTAAAATGCC
CGCCGGTGATCAACCAAAG -> GCCGGTGATCAACCAAAGC
CGCCTCGACATGAAGATCA -> GCCTCGACATGAAGATCAG
CGCCTCGAGCAGGTCTGCC -> GCCTCGAGCAGGTCTGCCG
CGCGGCTGTTCCAATTTGC -> GCGGCTGTTCCAATTTGCA
CGCGGTAAGCGATAGGTGA -> GCGGTAAGCGATAGGTGAC
CGCGGTCTGAAGGAGGTGC -> GCGGTCTGAAGGAGGTGCC
CGCGTCGTCGTGCTCAGTA -> GCGTCGTCGTGCTCAGTAT
CGCGTGAGTGTGCAATACG -> GCGTGAGTGTGCAATACGA
CGCGTTGTTCGGATACTCC -> GCGTTGTTCGGATACTCCC
CGCTCCTTGGTACCTATCC -> GCTCCTTGGTACCTATCCT
CGCTCGCCGAGCAGTGTAG -> GCTCGCCGAGCAGTGTAGC
CGCTGGGCCTAGGCAGACC -> GCTGGGCCTAGGCAGACCC
CGCTGGTCGCTGGGCCTAG -> GCTGGTCGCTGGGCCTAGG
CGCTTTCATCTGTTGAGCT -> GCTTTCATCTGTTGAGCTG
CGCTTTCTTCTGGTGAATA -> GCTTTCTTCTGGTGAATAT
CGGAAGGACCGGAGTGAAA -> GGAAGGACCGGAGTGAAAG
CGGAATATAGGCCTCTAGT -> GGAATATAGGCCTCTAGTC
CGGAGGTTATGCAATGATA -> GGAGGTTATGCAATGATAA
CGGAGTGAAAGAACGAAAC -> GGAGTGAAAGAACGAAACT
CGGATACTCCCTCTGAGTG -> GGATACTCCCTCTGAGTGT
CGGATTATTTGTCACAATT -> GGATTATTTGTCACAATTA
CGGCCGATTCCGCTTTCAT -> GGCCGATTCCGCTTTCATC
CGGCCTTATTACATCATTG -> GGCCTTATTACATCATTGA
CGGCGACTACTGGGGGTGG -> GGCGACTACTGGGGGTGGT
CGGCTAGCTTTCACTAGTT -> GGCTAGCTTTCACTAGTTA
CGGCTGTACATCCCGGGGA -> GGCTGTACATCCCGGGGAG
CGGCTGTTCCAATTTGCAG -> GGCTGTTCCAATTTGCAGG
CGGGATCTTATCAATTGAG -> GGGATCTTATCAATTGAGT
CGGGGAGGTGCTCCGTTCG -> GGGGAGGTGCTCCGTTCGT
CGGGGTCCTTAGTGAAAGA -> GGGGTCCTTAGTGAAAGAT
CGGGTCTTGAATAAAGTGA -> GGGTCTTGAATAAAGTGAG
CGGTAAGCGATAGGTGACA -> GGTAAGCGATAGGTGACAC
CGGTACTCTGTTGGGTAGA -> GGTACTCTGTTGGGTAGAT
CGGTAGAATTGGCACACTG -> GGTAGAATTGGCACACTGC
CGGTAGATTACACTACAAA -> GGTAGATTACACTACAAAA
CGGTAGCACGACCTCCAAA -> GGTAGCACGACCTCCAAAT
CGGTCTGAAGGAGGTGCCC -> GGTCTGAAGGAGGTGCCCT
CGGTCTTAGGGGATAACGT -> GGTCTTAGGGGATAACGTG
CGGTGATCAACCAAAGCAC -> GGTGATCAACCAAAGCACC
CGGTGATGCAGGGCGCGTG -> GGTGATGCAGGGCGCGTGA
CGGTGTACCCTTTTGGCAG -> GGTGTACCCTTTTGGCAGC
CGGTTGGGGAGAAGGGACA -> GGTTGGGGAGAAGGGACAA
CGTAAAACCACGGAAGGAC -> GTAAAACCACGGAAGGACC
CGTAACGATTTAGCTTCAA -> GTAACGATTTAGCTTCAAA
CGTAAGATTTGACAGCTCC -> GTAAGATTTGACAGCTCCT
CGTACCTGCGAAGTACCAA -> GTACCTGCGAAGTACCAAA
CGTACTGGTGCTCCAGGGC -> GTACTGGTGCTCCAGGGCA
CGTAGCAGAGCAGTTCATG -> GTAGCAGAGCAGTTCATGG
CGTAGCCGGTAGCACGACC -> GTAGCCGGTAGCACGACCT
CGTATAATATCGCCCAAAG -> GTATAATATCGCCCAAAGA
CGTATAATGCCATTTGGCT -> GTATAATGCCATTTGGCTA
CGTCATACTGCGCGTTGTT -> GTCATACTGCGCGTTGTTC
CGTCGCTCGCCGAGCAGTG -> GTCGCTCGCCGAGCAGTGT
CGTCGTCGTGCTCAGTATG -> GTCGTCGTGCTCAGTATGA
CGTCGTGCTCAGTATGAAG -> GTCGTGCTCAGTATGAAGG,GTCGTGCTCAGTATGAAGA,GTCGTGCTCAGTATGAAGG
CGTCGTGCTCAGTATGAAT -> GTCGTGCTCAGTATGAATA
CGTGAGCGACCTATACTCA -> GTGAGCGACCTATACTCAT
CGTGAGTGTGCAATACGAG -> GTGAGTGTGCAATACGAGA
CGTGCTCAGTATGAAGAGC -> GTGCTCAGTATGAAGAGCC
CGTGCTCAGTATGAAGGAC -> GTGCTCAGTATGAAGGACG
CGTGCTCAGTATGAAGGGA -> GTGCTCAGTATGAAGGGAC
CGTGCTCAGTATGAATAAT -> GTGCTCAGTATGAATAATC
CGTGCTGCGAGTATTACAG -> GTGCTGCGAGTATTACAGT
CGTGGACGAAATTATACAT -> GTGGACGAAATTATACATG
CGTGGCGGCCGATTCCGCT -> GTGGCGGCCGATTCCGCTT
CGTTCGTTTGACTGGCCGC -> GTTCGTTTGACTGGCCGCT
CGTTCTGTGGCTCGACAGG -> GTTCTGTGGCTCGACAGGC
CGTTGAAGCATGGTTAAAA -> GTTGAAGCATGGTTAAAAT
CGTTGTTCGGATACTCCCT -> GTTGTTCGGATACTCCCTC
CGTTTGACTGGCCGCTCCT -> GTTTGACTGGCCGCTCCTT
CGTTTTATTGTTATAGGCC -> GTTTTATTGTTATAGGCCA
CTAAGCCCGGCCTTATTAC -> TAAGCCCGGCCTTATTACA
CTAAGCTAGGAGTTTCGTC -> TAAGCTAGGAGTTTCGTCG
CTAAGGGACCGTATAATAT -> TAAGGGACCGTATAATATC
CTAATCCTATTCAATGAGC -> TAATCCTATTCAATGAGCG
CTACAAAAGAAATTTGGCG -> TACAAAAGAAATTTGGCGT
CTACACTTGTACGGTGATG -> TACACTTGTACGGTGATGC
CTACCACTTTGCGATCGTC -> TACCACTTTGCGATCGTCG
CTACCATCAGCTTTCCGAG -> TACCATCAGCTTTCCGAGG
CTACCATCGGGATCTTATC -> TACCATCGGGATCTTATCA
CTACCCCAACATAGTTACT -> TACCCCAACATAGTTACTC
CTACCGTTCTGTGGCTCGA -> TACCGTTCTGTGGCTCGAC
CTACCTCCGGTAGAATTGG -> TACCTCCGGTAGAATTGGC
CTACGCGGTCTGAAGGAGG -> TACGCGGTCTGAAGGAGGT
CTACTCGGAGGTTATGCAA -> TACTCGGAGGTTATGCAAT
CTACTGACGGCTAGCTTTC -> TACTGACGGCTAGCTTTCA
CTACTGGGGGTGGTAATGT -> TACTGGGGGTGGTAATGTA
CTACTTAATTTTCCCTACC -> TACTTAATTTTCCCTACCC
CTAGAAGTGAGGCAGGTCG -> TAGAAGTGAGGCAGGTCGA
CTAGAGCCATATTGACCAA -> TAGAGCCATATTGACCAAT
CTAGATACTTTGGTATCAT -> TAGATACTTTGGTATCATC
CTAGCATAGCGACATTTAG -> TAGCATAGCGACATTTAGC
CTAGCTTTCACTAGTTAAC -> TAGCTTTCACTAGTTAACC
CTAGGAGTTTCGTCGTGCT -> TAGGAGTTTCGTCGTGCTC
CTAGGCAGACCCGTAACGA -> TAGGCAGACCCGTAACGAT
CTAGGGCATAGTGCTCGTC -> TAGGGCATAGTGCTCGTCG
CTAGTCACAACTACGCGGT -> TAGTCACAACTACGCGGTC
CTAGTCTTTTACCCGAATT -> TAGTCTTTTACCCGAATTC
CTAGTGAGTATTCTTGTCT -> TAGTGAGTATTCTTGTCTC
CTAGTTAACCCTACCGTTC -> TAGTTAACCCTACCGTTCT
CTATAATAACTCCGCCGAT -> TATAATAACTCCGCCGATG
CTATACTCATGGCGAGACT -> TATACTCATGGCGAGACTA
CTATACTTCATGTCGATCT -> TATACTTCATGTCGATCTA
CTATCCCCGTATAATGCCA -> TATCCCCGTATAATGCCAT
CTATCCTGGCTGCGTACTG -> TATCCTGGCTGCGTACTGG
CTATGTACAGCGCGTCGTC -> TATGTACAGCGCGTCGTCG
CTATTCAATGAGCGCCCGA -> TATTCAATGAGCGCCCGAT
CTCAACGGCTGTACATCCC -> TCAACGGCTGTACATCCCG
CTCAAGCACACACCAAACG -> TCAAGCACACACCAAACGA
CTCACAATGTATGAGCCAT -> TCACAATGTATGAGCCATG
CTCAGCAAACGGGGTCCTT -> TCAGCAAACGGGGTCCTTA
CTCAGTATGAAGAGCCTTA -> TCAGTATGAAGAGCCTTAC
CTCAGTATGAAGGACGTGG -> TCAGTATGAAGGACGTGGC
CTCAGTATGAAGGGACAGA -> TCAGTATGAAGGGACAGAA
CTCAGTATGAATAATCTAG -> TCAGTATGAATAATCTAGA
CTCAGTTTAAACTGCTACC -> TCAGTTTAAACTGCTACCA
CTCATGGCGAGACTATCCC -> TCATGGCGAGACTATCCCC
CTCATTGCGGTTGGGGAGA -> TCATTGCGGTTGGGGAGAA
CTCCAAATCGCCGATAGTC -> TCCAAATCGCCGATAGTCC
CTCCAGGGCACCTTCTCAT -> TCCAGGGCACCTTCTCATT
CTCCCAACTGCATAAATTC -> TCCCAACTGCATAAATTCT
CTCCCTCTGAGTGTGGCTC -> TCCCTCTGAGTGTGGCTCA
CTCCGATTAGCATCGTAGC -> TCCGATTAGCATCGTAGCC
CTCCGCCCGATGTCGGGTC -> TCCGCCCGATGTCGGGTCT
CTCCGCCGATGAAGTAAAA -> TCCGCCGATGAAGTAAAAT
CTCCGGTAGAATTGGCACA -> TCCGGTAGAATTGGCACAC
CTCCGTTCGTTTGACTGGC -> TCCGTTCGTTTGACTGGCC
CTCCTAATCCTATTCAATG -> TCCTAATCCTATTCAATGA
CTCCTAGAAGTGAGGCAGG -> TCCTAGAAGTGAGGCAGGT
CTCCTTGGTACCTATCCTG -> TCCTTGGTACCTATCCTGG
CTCGACACTCCCAACTGCA -> TCGACACTCCCAACTGCAT
CTCGACAGGCGACTCGTAC -> TCGACAGGCGACTCGTACC
CTCGACATGAAGATCAGTT -> TCGACATGAAGATCAGTTA
CTCGAGCAGGTCTGCCGCT -> TCGAGCAGGTCTGCCGCTT
CTCGCCGAGCAGTGTAGCT -> TCGCCGAGCAGTGTAGCTC
CTCGCCGGTGATCAACCAA -> TCGCCGGTGATCAACCAAA
CTCGGAGGTTATGCAATGA -> TCGGAGGTTATGCAATGAT
CTCGTACCTGCGAAGTACC -> TCGTACCTGCGAAGTACCA
CTCGTCGTGCTCAGTATGA -> TCGTCGTGCTCAGTATGAA
CTCTAGTCTTTTACCCGAA -> TCTAGTCTTTTACCCGAAT
CTCTGAGTGTGGCTCAGCA -> TCTGAGTGTGGCTCAGCAA
CTCTGCTTATCGCACGCAT -> TCTGCTTATCGCACGCATG
CTCTGTTGGGTAGATTTAC -> TCTGTTGGGTAGATTTACC
CTCTTTACGCAGTACTCCG -> TCTTTACGCAGTACTCCGC
CTCTTTGTCGCGGTAAGCG -> TCTTTGTCGCGGTAAGCGA
CTGAAGGAGGTGCCCTAGT -> TGAAGGAGGTGCCCTAGTG
CTGACGCTGGTCGCTGGGC -> TGACGCTGGTCGCTGGGCC
CTGACGGCTAGCTTTCACT -> TGACGGCTAGCTTTCACTA
CTGACTCTTTGTCGCGGTA -> TGACTCTTTGTCGCGGTAA
CTGAGTGTGGCTCAGCAAA -> TGAGTGTGGCTCAGCAAAC
CTGATGCCAGATTATAACC -> TGATGCCAGATTATAACCC
CTGATGCGTAGCAGAGCAG -> TGATGCGTAGCAGAGCAGT
CTGCATAAATTCTGTCACT -> TGCATAAATTCTGTCACTG
CTGCATCTGACGCTGGTCG -> TGCATCTGACGCTGGTCGC
CTGCCGCTTTCTTCTGGTG -> TGCCGCTTTCTTCTGGTGA
CTGCGAAGTACCAAACGCC -> TGCGAAGTACCAAACGCCA
CTGCGAGTATTACAGTCTA -> TGCGAGTATTACAGTCTAT
CTGCGCGTTGTTCGGATAC -> TGCGCGTTGTTCGGATACT
CTGCGGAATATAGGCCTCT -> TGCGGAATATAGGCCTCTA
CTGCGGCGACTACTGGGGG -> TGCGGCGACTACTGGGGGT
CTGCGTACTGGTGCTCCAG -> TGCGTACTGGTGCTCCAGG
CTGCTACCATCGGGATCTT -> TGCTACCATCGGGATCTTA
CTGCTACTCGGAGGTTATG -> TGCTACTCGGAGGTTATGC
CTGCTTATCGCACGCATGG -> TGCTTATCGCACGCATGGA
CTGGCCGCTCCTTGGTACC -> TGGCCGCTCCTTGGTACCT
CTGGCTGCGTACTGGTGCT -> TGGCTGCGTACTGGTGCTC
CTGGGCCTAGGCAGACCCG -> TGGGCCTAGGCAGACCCGT
CTGGGGGTGGTAATGTACT -> TGGGGGTGGTAATGTACTG
CTGGTCGCTGGGCCTAGGC -> TGGTCGCTGGGCCTAGGCA
CTGGTGAATATAGAGGGCC -> TGGTGAATATAGAGGGCCA
CTGGTGCTCCAGGGCACCT -> TGGTGCTCCAGGGCACCTT
CTGGTTCCAAAAACCGTTT -> TGGTTCCAAAAACCGTTTT
CTGTAAGCAATTGCTGGTT -> TGTAAGCAATTGCTGGTTC
CTGTACATCCCGGGGAGGT -> TGTACATCCCGGGGAGGTG
CTGTCACTGACTCTTTGTC -> TGTCACTGACTCTTTGTCG
CTGTCTGTAAGCAATTGCT -> TGTCTGTAAGCAATTGCTG
CTGTGATCGTAAAACCACG -> TGTGATCGTAAAACCACGG
CTGTGGCGAGTAATAGATA -> TGTGGCGAGTAATAGATAA
CTGTGGCTCGACAGGCGAC -> TGTGGCTCGACAGGCGACT
CTGTTCCAATTTGCAGGTC -> TGTTCCAATTTGCAGGTCA
CTGTTGAGCTGCGGAATAT -> TGTTGAGCTGCGGAATATA
CTGTTGGGTAGATTTACCC -> TGTTGGGTAGATTTACCCT
CTTAATTTGATATCGTCAT -> TTAATTTGATATCGTCATA
CTTAATTTTCCCTACCCCA -> TTAATTTTCCCTACCCCAA
CTTACGATTCGACAAGATG -> TTACGATTCGACAAGATGA
CTTAGGGGATAACGTGCTG -> TTAGGGGATAACGTGCTGC
CTTAGTGAAAGATCGTGGA -> TTAGTGAAAGATCGTGGAC
CTTATCAATTGAGTCCCCC -> TTATCAATTGAGTCCCCCT
CTTATTACATCATTGACAG -> TTATTACATCATTGACAGA
CTTCAAACAAGTTTATTCG -> TTCAAACAAGTTTATTCGG
CTTCAAGATTAAAAATACA -> TTCAAGATTAAAAATACAG
CTTCATGTCGATCTACTGA -> TTCATGTCGATCTACTGAC
CTTCGAGCTACCATCAGCT -> TTCGAGCTACCATCAGCTT
CTTCTCATTGCGGTTGGGG -> TTCTCATTGCGGTTGGGGA
CTTCTGGTGAATATAGAGG -> TTCTGGTGAATATAGAGGG
CTTGAATAAAGTGAGACAC -> TTGAATAAAGTGAGACACA
CTTGGTACCTATCCTGGCT -> TTGGTACCTATCCTGGCTG
CTTGTACGGTGATGCAGGG -> TTGTACGGTGATGCAGGGC
CTTGTCTCAAGCACACACC -> TTGTCTCAAGCACACACCA
CTTTACGCAGTACTCCGCC -> TTTACGCAGTACTCCGCCC
CTTTCACTAGTTAACCCTA -> TTTCACTAGTTAACCCTAC
CTTTCATCTGTTGAGCTGC -> TTTCATCTGTTGAGCTGCG
CTTTCCCTTCGAGCTACCA -> TTTCCCTTCGAGCTACCAT
CTTTCCGAGGCTCCGATTA -> TTTCCGAGGCTCCGATTAG
CTTTCTTCTGGTGAATATA -> TTTCTTCTGGTGAATATAG
CTTTGCGATCGTCGTGCTC -> TTTGCGATCGTCGTGCTCA
CTTTGGTATCATCTCACAA -> TTTGGTATCATCTCACAAT
CTTTGTCGCGGTAAGCGAT -> TTTGTCGCGGTAAGCGATA
CTTTTACCCGAATTCCATT -> TTTTACCCGAATTCCATTG
CTTTTGGCAGCGACAAAGT -> TTTTGGCAGCGACAAAGTG
GAAAAGTGAGACACAAGCT -> AAAAGTGAGACACAAGCTA
GAAACTCGCCGGTGATCAA -> AAACTCGCCGGTGATCAAC
GAAAGAACGAAACTCGCCG -> AAAGAACGAAACTCGCCGG
GAAAGATCGTGGACGAAAT -> AAAGATCGTGGACGAAATT
GAAAGTGAGACACAAGCTA -> AAAGTGAGACACAAGCTAG
GAAATTATACATGAGTGTT -> AAATTATACATGAGTGTTC
GAAATTTGGCGTGAGCGAC -> AAATTTGGCGTGAGCGACC
GAACACGATTCCACATTAG -> AACACGATTCCACATTAGA
GAACACTAGCATAGCGACA -> AACACTAGCATAGCGACAT
GAACGAAACTCGCCGGTGA -> AACGAAACTCGCCGGTGAT
GAACGATAGTGCCCGCCTC -> AACGATAGTGCCCGCCTCG
GAACGATGTTCGAAGAACG -> AACGATGTTCGAAGAACGA
GAACTACTTAATTTTCCCT -> AACTACTTAATTTTCCCTA
GAAGAACGATAGTGCCCGC -> AAGAACGATAGTGCCCGCC
GAAGAGCCTTACGATTCGA -> AAGAGCCTTACGATTCGAC
GAAGATCAGTTAAGGTTAC -> AAGATCAGTTAAGGTTACG
GAAGATGAGTGTGAAAAGT -> AAGATGAGTGTGAAAAGTG
GAAGCATGGTTAAAATCGT -> AAGCATGGTTAAAATCGTC
GAAGGACCGGAGTGAAAGA -> AAGGACCGGAGTGAAAGAA
GAAGGACGTGGCGGCCGAT -> AAGGACGTGGCGGCCGATT
GAAGGAGGTGCCCTAGTGA -> AAGGAGGTGCCCTAGTGAG
GAAGGGACAAACAGTCCTA -> AAGGGACAAACAGTCCTAT
GAAGGGACAGAACACGATT -> AAGGGACAGAACACGATTC
GAAGTAAAATGCCCCGGTC -> AAGTAAAATGCCCCGGTCT
GAAGTACCAAACGCCAGGG -> AAGTACCAAACGCCAGGGC
GAAGTGAGGCAGGTCGAAC -> AAGTGAGGCAGGTCGAACT
GAATAAAGTGAGACACAAG -> AATAAAGTGAGACACAAGC
GAATAACGCGGCTGTTCCA -> AATAACGCGGCTGTTCCAA
GAATAATCTAGATACTTTG -> AATAATCTAGATACTTTGG
GAATATAGAGGGCCAGTAC -> AATATAGAGGGCCAGTACG
GAATATAGGCCTCTAGTCT -> AATATAGGCCTCTAGTCTT
GAATGATCCTCAACGGCTG -> AATGATCCTCAACGGCTGT
GAATTCCATTGCGACTAGT -> AATTCCATTGCGACTAGTC
GAATTGGCACACTGCTACT -> AATTGGCACACTGCTACTC
GACAAACAGTCCTATAATA -> ACAAACAGTCCTATAATAA
GACAAAGTGAGACACAAGC -> ACAAAGTGAGACACAAGCT
GACAAGATGACGAGAATGA -> ACAAGATGACGAGAATGAT
GACACAAGCTAAGCTAGGA -> ACACAAGCTAAGCTAGGAG
GACACAAGCTACCACTTTG -> ACACAAGCTACCACTTTGC
GACACAAGCTAGGGCATAG -> ACACAAGCTAGGGCATAGT
GACACAAGCTATGTACAGC -> ACACAAGCTATGTACAGCG
GACACCAACCCACTAAGGG -> ACACCAACCCACTAAGGGA
GACACGGTAGATTACACTA -> ACACGGTAGATTACACTAC
GACACTCCCAACTGCATAA -> ACACTCCCAACTGCATAAA
GACAGAACACGATTCCACA -> ACAGAACACGATTCCACAT
GACAGATGGCAGTAAGAGT -> ACAGATGGCAGTAAGAGTA
GACAGCTCCTAGAAGTGAG -> ACAGCTCCTAGAAGTGAGG
GACAGGCGACTCGTACCTG -> ACAGGCGACTCGTACCTGC
GACATGAAGATCAGTTAAG -> ACATGAAGATCAGTTAAGG
GACATTTAGCAGACCCCCG -> ACATTTAGCAGACCCCCGC
GACCAATTTGTTCCAACCT -> ACCAATTTGTTCCAACCTG
GACCCCCGCAACCTTCAAG -> ACCCCCGCAACCTTCAAGA
GACCCGTAACGATTTAGCT -> ACCCGTAACGATTTAGCTT
GACCGGAGTGAAAGAACGA -> ACCGGAGTGAAAGAACGAA
GACCGTATAATATCGCCCA -> ACCGTATAATATCGCCCAA
GACCTATACTCATGGCGAG -> ACCTATACTCATGGCGAGA
GACCTCCAAATCGCCGATA -> ACCTCCAAATCGCCGATAG
GACGAAATTATACATGAGT -> ACGAAATTATACATGAGTG
GACGAGAATGATCCTCAAC -> ACGAGAATGATCCTCAACG
GACGCTGGTCGCTGGGCCT -> ACGCTGGTCGCTGGGCCTA
GACGGCTAGCTTTCACTAG -> ACGGCTAGCTTTCACTAGT
GACGTGGCGGCCGATTCCG -> ACGTGGCGGCCGATTCCGC
GACTACTGGGGGTGGTAAT -> ACTACTGGGGGTGGTAATG
GACTAGTCACAACTACGCG -> ACTAGTCACAACTACGCGG
GACTATCCCCGTATAATGC -> ACTATCCCCGTATAATGCC
GACTCGTACCTGCGAAGTA -> ACTCGTACCTGCGAAGTAC
GACTCTTTGTCGCGGTAAG -> ACTCTTTGTCGCGGTAAGC
GACTGGCCGCTCCTTGGTA -> ACTGGCCGCTCCTTGGTAC
GACTTTCCCTTCGAGCTAC -> ACTTTCCCTTCGAGCTACC
GAGAACACTAGCATAGCGA -> AGAACACTAGCATAGCGAC
GAGAAGGGACAAACAGTCC -> AGAAGGGACAAACAGTCCT
GAGAATGATCCTCAACGGC -> AGAATGATCCTCAACGGCT
GAGACACAAGCTAAGCTAG -> AGACACAAGCTAAGCTAGG
GAGACACAAGCTACCACTT -> AGACACAAGCTACCACTTT
GAGACACAAGCTAGGGCAT -> AGACACAAGCTAGGGCATA
GAGACACAAGCTATGTACA -> AGACACAAGCTATGTACAG
GAGACTATCCCCGTATAAT -> AGACTATCCCCGTATAATG
GAGCAGGTCTGCCGCTTTC -> AGCAGGTCTGCCGCTTTCT
GAGCAGTGTAGCTCGACAC -> AGCAGTGTAGCTCGACACT
GAGCAGTTCATGGAAAGTG -> AGCAGTTCATGGAAAGTGA
GAGCCATATTGACCAATTT -> AGCCATATTGACCAATTTG
GAGCCATGCCCCGGTACTC -> AGCCATGCCCCGGTACTCT
GAGCCTTACGATTCGACAA -> AGCCTTACGATTCGACAAG
GAGCGACCTATACTCATGG -> AGCGACCTATACTCATGGC
GAGCGCCCGATAGGTTACT -> AGCGCCCGATAGGTTACTC
GAGCTACCATCAGCTTTCC -> AGCTACCATCAGCTTTCCG
GAGCTGCGGAATATAGGCC -> AGCTGCGGAATATAGGCCT
GAGGCAGGTCGAACTACTT -> AGGCAGGTCGAACTACTTA
GAGGCTCCGATTAGCATCG -> AGGCTCCGATTAGCATCGT
GAGGGCCAGTACGCAGACT -> AGGGCCAGTACGCAGACTT
GAGGTGCCCTAGTGAGTAT -> AGGTGCCCTAGTGAGTATT
GAGGTGCTCCGTTCGTTTG -> AGGTGCTCCGTTCGTTTGA
GAGGTGGCCCCCTGTCTGT -> AGGTGGCCCCCTGTCTGTA
GAGGTTATGCAATGATAAT -> AGGTTATGCAATGATAATT
GAGTAATAGATAACTGATG -> AGTAATAGATAACTGATGC
GAGTACACACAGTGTTAAT -> AGTACACACAGTGTTAATT
GAGTAGACACCAACCCACT -> AGTAGACACCAACCCACTA
GAGTATTACAGTCTATACT -> AGTATTACAGTCTATACTT
GAGTATTCTTGTCTCAAGC -> AGTATTCTTGTCTCAAGCA
GAGTCCCCCTCCTAATCCT -> AGTCCCCCTCCTAATCCTA
GAGTGAAAGAACGAAACTC -> AGTGAAAGAACGAAACTCG
GAGTGTGAAAAGTGAGACA -> AGTGTGAAAAGTGAGACAC
GAGTGTGCAATACGAGAAC -> AGTGTGCAATACGAGAACA
GAGTGTGGCTCAGCAAACG -> AGTGTGGCTCAGCAAACGG
GAGTGTTCCATAATTGTCT -> AGTGTTCCATAATTGTCTG
GAGTTTCGTCGTGCTCAGT -> AGTTTCGTCGTGCTCAGTA
GATAAAGGCGGATTATTTG -> ATAAAGGCGGATTATTTGT
GATAACGTGCTGCGAGTAT -> ATAACGTGCTGCGAGTATT
GATAACTGATGCCAGATTA -> ATAACTGATGCCAGATTAT
GATAATTCACAGGAGTAGA -> ATAATTCACAGGAGTAGAC
GATACTCCCTCTGAGTGTG -> ATACTCCCTCTGAGTGTGG
GATACTTTGGTATCATCTC -> ATACTTTGGTATCATCTCA
GATAGGTGACACGGTAGAT -> ATAGGTGACACGGTAGATT
GATAGGTTACTCTGCTTAT -> ATAGGTTACTCTGCTTATC
GATAGTCCGTAAGATTTGA -> ATAGTCCGTAAGATTTGAC
GATAGTGCCCGCCTCGAGC -> ATAGTGCCCGCCTCGAGCA
GATATCGTCATACTGCGCG -> ATATCGTCATACTGCGCGT
GATCAACCAAAGCACCCGC -> ATCAACCAAAGCACCCGCA
GATCAGTTAAGGTTACGTT -> ATCAGTTAAGGTTACGTTG
GATCCTCAACGGCTGTACA -> ATCCTCAACGGCTGTACAT
GATCGTAAAACCACGGAAG -> ATCGTAAAACCACGGAAGG
GATCGTCGTGCTCAGTATG -> ATCGTCGTGCTCAGTATGA
GATCGTGGACGAAATTATA -> ATCGTGGACGAAATTATAC
GATCTACTGACGGCTAGCT -> ATCTACTGACGGCTAGCTT
GATCTTATCAATTGAGTCC -> ATCTTATCAATTGAGTCCC
GATGAAGTAAAATGCCCCG -> ATGAAGTAAAATGCCCCGG
GATGACGAGAATGATCCTC -> ATGACGAGAATGATCCTCA
GATGAGTGTGAAAAGTGAG -> ATGAGTGTGAAAAGTGAGA
GATGCAGGGCGCGTGAGTG -> ATGCAGGGCGCGTGAGTGT
GATGCCAGATTATAACCCT -> ATGCCAGATTATAACCCTA
GATGCGTAGCAGAGCAGTT -> ATGCGTAGCAGAGCAGTTC
GATGGCAGTAAGAGTACAC -> ATGGCAGTAAGAGTACACA
GATGTCGGGTCTTGAATAA -> ATGTCGGGTCTTGAATAAA
GATGTTCGAAGAACGATAG -> ATGTTCGAAGAACGATAGT
GATTAAAAATACAGTCTGA -> ATTAAAAATACAGTCTGAT
GATTACACTACAAAAGAAA -> ATTACACTACAAAAGAAAT
GATTAGCATCGTAGCCGGT -> ATTAGCATCGTAGCCGGTA
GATTATAACCCTACCTCCG -> ATTATAACCCTACCTCCGG
GATTATTTGTCACAATTAC -> ATTATTTGTCACAATTACC
GATTCCACATTAGATAAAG -> ATTCCACATTAGATAAAGG
GATTCCGCTTTCATCTGTT -> ATTCCGCTTTCATCTGTTG
GATTCGACAAGATGACGAG -> ATTCGACAAGATGACGAGA
GATTTACCCTTAATTTGAT -> ATTTACCCTTAATTTGATA
GATTTAGCTTCAAACAAGT -> ATTTAGCTTCAAACAAGTT
GATTTGACAGCTCCTAGAA -> ATTTGACAGCTCCTAGAAG
GCAAACGGGGTCCTTAGTG -> CAAACGGGGTCCTTAGTGA
GCAACCTTCAAGATTAAAA -> CAACCTTCAAGATTAAAAA
GCAATACGAGAACACTAGC -> CAATACGAGAACACTAGCA
GCAATGATAATTCACAGGA -> CAATGATAATTCACAGGAG
GCAATTGCTGGTTCCAAAA -> CAATTGCTGGTTCCAAAAA
GCACACACCAAACGAGGTG -> CACACACCAAACGAGGTGG
GCACACTGCTACTCGGAGG -> CACACTGCTACTCGGAGGT
GCACCCGCACTACACTTGT -> CACCCGCACTACACTTGTA
GCACCTTCTCATTGCGGTT -> CACCTTCTCATTGCGGTTG
GCACGACCTCCAAATCGCC -> CACGACCTCCAAATCGCCG
GCACTACACTTGTACGGTG -> CACTACACTTGTACGGTGA
GCAGACCCCCGCAACCTTC -> CAGACCCCCGCAACCTTCA
GCAGACCCGTAACGATTTA -> CAGACCCGTAACGATTTAG
GCAGACTTTCCCTTCGAGC -> CAGACTTTCCCTTCGAGCT
GCAGAGCAGTTCATGGAAA -> CAGAGCAGTTCATGGAAAG
GCAGCGACAAAGTGAGACA -> CAGCGACAAAGTGAGACAC
GCAGGGCGCGTGAGTGTGC -> CAGGGCGCGTGAGTGTGCA
GCAGGTCAATAAGGTTTAT -> CAGGTCAATAAGGTTTATG
GCAGGTCGAACTACTTAAT -> CAGGTCGAACTACTTAATT
GCAGGTCTGCCGCTTTCTT -> CAGGTCTGCCGCTTTCTTC
GCAGTAAGAGTACACACAG -> CAGTAAGAGTACACACAGT
GCAGTACTCCGCCCGATGT -> CAGTACTCCGCCCGATGTC
GCAGTGTAGCTCGACACTC -> CAGTGTAGCTCGACACTCC
GCAGTTCATGGAAAGTGAG -> CAGTTCATGGAAAGTGAGA
GCATAAATTCTGTCACTGA -> CATAAATTCTGTCACTGAC
GCATAGCGACATTTAGCAG -> CATAGCGACATTTAGCAGA
GCATAGTGCTCGTCGTGCT -> CATAGTGCTCGTCGTGCTC
GCATCGTAGCCGGTAGCAC -> CATCGTAGCCGGTAGCACG
GCATCTCTTTACGCAGTAC -> CATCTCTTTACGCAGTACT
GCATCTGACGCTGGTCGCT -> CATCTGACGCTGGTCGCTG
GCATGGTTAAAATCGTCGC -> CATGGTTAAAATCGTCGCT
GCCAGAACGATGTTCGAAG -> CCAGAACGATGTTCGAAGA
GCCAGATTATAACCCTACC -> CCAGATTATAACCCTACCT
GCCAGGGCATCTCTTTACG -> CCAGGGCATCTCTTTACGC
GCCAGTACGCAGACTTTCC -> CCAGTACGCAGACTTTCCC
GCCATATTGACCAATTTGT -> CCATATTGACCAATTTGTT
GCCATGCCCCGGTACTCTG -> CCATGCCCCGGTACTCTGT
GCCATTTGGCTAAGCCCGG -> CCATTTGGCTAAGCCCGGC
GCCCAAAGAATAACGCGGC -> CCCAAAGAATAACGCGGCT
GCCCCCTGTCTGTAAGCAA -> CCCCCTGTCTGTAAGCAAT
GCCCCGGTACTCTGTTGGG -> CCCCGGTACTCTGTTGGGT
GCCCCGGTCTTAGGGGATA -> CCCCGGTCTTAGGGGATAA
GCCCGATAGGTTACTCTGC -> CCCGATAGGTTACTCTGCT
GCCCGATGTCGGGTCTTGA -> CCCGATGTCGGGTCTTGAA
GCCCGCCTCGAGCAGGTCT -> CCCGCCTCGAGCAGGTCTG
GCCCGGCCTTATTACATCA -> CCCGGCCTTATTACATCAT
GCCCTAGTGAGTATTCTTG -> CCCTAGTGAGTATTCTTGT
GCCGAGCAGTGTAGCTCGA -> CCGAGCAGTGTAGCTCGAC
GCCGATAGTCCGTAAGATT -> CCGATAGTCCGTAAGATTT
GCCGATGAAGTAAAATGCC -> CCGATGAAGTAAAATGCCC
GCCGATTCCGCTTTCATCT -> CCGATTCCGCTTTCATCTG
GCCGCTCCTTGGTACCTAT -> CCGCTCCTTGGTACCTATC
GCCGCTTTCTTCTGGTGAA -> CCGCTTTCTTCTGGTGAAT
GCCGGTAGCACGACCTCCA -> CCGGTAGCACGACCTCCAA
GCCGGTGATCAACCAAAGC -> CCGGTGATCAACCAAAGCA
GCCTAGGCAGACCCGTAAC -> CCTAGGCAGACCCGTAACG
GCCTCGACATGAAGATCAG -> CCTCGACATGAAGATCAGT
GCCTCGAGCAGGTCTGCCG -> CCTCGAGCAGGTCTGCCGC
GCCTCTAGTCTTTTACCCG -> CCTCTAGTCTTTTACCCGA
GCCTTACGATTCGACAAGA -> CCTTACGATTCGACAAGAT
GCCTTATTACATCATTGAC -> CCTTATTACATCATTGACA
GCGAAGTACCAAACGCCAG -> CGAAGTACCAAACGCCAGG
GCGACAAAGTGAGACACAA -> CGACAAAGTGAGACACAAG
GCGACATTTAGCAGACCCC -> CGACATTTAGCAGACCCCC
GCGACCTATACTCATGGCG -> CGACCTATACTCATGGCGA
GCGACTACTGGGGGTGGTA -> CGACTACTGGGGGTGGTAA
GCGACTAGTCACAACTACG -> CGACTAGTCACAACTACGC
GCGACTCGTACCTGCGAAG -> CGACTCGTACCTGCGAAGT
GCGAGACTATCCCCGTATA -> CGAGACTATCCCCGTATAA
GCGAGTAATAGATAACTGA -> CGAGTAATAGATAACTGAT
GCGAGTATTACAGTCTATA -> CGAGTATTACAGTCTATAC
GCGATAGGTGACACGGTAG -> CGATAGGTGACACGGTAGA
GCGATCGTCGTGCTCAGTA -> CGATCGTCGTGCTCAGTAT
GCGCCCGATAGGTTACTCT -> CGCCCGATAGGTTACTCTG
GCGCCTCGACATGAAGATC -> CGCCTCGACATGAAGATCA
GCGCGTCGTCGTGCTCAGT -> CGCGTCGTCGTGCTCAGTA
GCGCGTGAGTGTGCAATAC -> CGCGTGAGTGTGCAATACG
GCGCGTTGTTCGGATACTC -> CGCGTTGTTCGGATACTCC
GCGGAATATAGGCCTCTAG -> CGGAATATAGGCCTCTAGT
GCGGATTATTTGTCACAAT -> CGGATTATTTGTCACAATT
GCGGCCGATTCCGCTTTCA -> CGGCCGATTCCGCTTTCAT
GCGGCGACTACTGGGGGTG -> CGGCGACTACTGGGGGTGG
GCGGCTGTTCCAATTTGCA -> CGGCTGTTCCAATTTGCAG
GCGGTAAGCGATAGGTGAC -> CGGTAAGCGATAGGTGACA
GCGGTCTGAAGGAGGTGCC -> CGGTCTGAAGGAGGTGCCC
GCGGTTGGGGAGAAGGGAC -> CGGTTGGGGAGAAGGGACA
GCGTACTGGTGCTCCAGGG -> CGTACTGGTGCTCCAGGGC
GCGTAGCAGAGCAGTTCAT -> CGTAGCAGAGCAGTTCATG
GCGTCGTCGTGCTCAGTAT -> CGTCGTCGTGCTCAGTATG
GCGTGAGCGACCTATACTC -> CGTGAGCGACCTATACTCA
GCGTGAGTGTGCAATACGA -> CGTGAGTGTGCAATACGAG
GCGTTGTTCGGATACTCCC -> CGTTGTTCGGATACTCCCT
GCTAAGCCCGGCCTTATTA -> CTAAGCCCGGCCTTATTAC
GCTAAGCTAGGAGTTTCGT -> CTAAGCTAGGAGTTTCGTC
GCTACCACTTTGCGATCGT -> CTACCACTTTGCGATCGTC
GCTACCATCAGCTTTCCGA -> CTACCATCAGCTTTCCGAG
GCTACCATCGGGATCTTAT -> CTACCATCGGGATCTTATC
GCTACTCGGAGGTTATGCA -> CTACTCGGAGGTTATGCAA
GCTAGAGCCATATTGACCA -> CTAGAGCCATATTGACCAA
GCTAGCTTTCACTAGTTAA -> CTAGCTTTCACTAGTTAAC
GCTAGGAGTTTCGTCGTGC -> CTAGGAGTTTCGTCGTGCT
GCTAGGGCATAGTGCTCGT -> CTAGGGCATAGTGCTCGTC
GCTATGTACAGCGCGTCGT -> CTATGTACAGCGCGTCGTC
GCTCAGCAAACGGGGTCCT -> CTCAGCAAACGGGGTCCTT
GCTCAGTATGAAGAGCCTT -> CTCAGTATGAAGAGCCTTA
GCTCAGTATGAAGGACGTG -> CTCAGTATGAAGGACGTGG
GCTCAGTATGAAGGGACAG -> CTCAGTATGAAGGGACAGA
GCTCAGTATGAATAATCTA -> CTCAGTATGAATAATCTAG
GCTCCAGGGCACCTTCTCA -> CTCCAGGGCACCTTCTCAT
GCTCCGATTAGCATCGTAG -> CTCCGATTAGCATCGTAGC
GCTCCGTTCGTTTGACTGG -> CTCCGTTCGTTTGACTGGC
GCTCCTAGAAGTGAGGCAG -> CTCCTAGAAGTGAGGCAGG
GCTCCTTGGTACCTATCCT -> CTCCTTGGTACCTATCCTG
GCTCGACACTCCCAACTGC -> CTCGACACTCCCAACTGCA
GCTCGACAGGCGACTCGTA -> CTCGACAGGCGACTCGTAC
GCTCGCCGAGCAGTGTAGC -> CTCGCCGAGCAGTGTAGCT
GCTCGTCGTGCTCAGTATG -> CTCGTCGTGCTCAGTATGA
GCTGCGAGTATTACAGTCT -> CTGCGAGTATTACAGTCTA
GCTGCGGAATATAGGCCTC -> CTGCGGAATATAGGCCTCT
GCTGCGTACTGGTGCTCCA -> CTGCGTACTGGTGCTCCAG
GCTGGGCCTAGGCAGACCC -> CTGGGCCTAGGCAGACCCG
GCTGGTCGCTGGGCCTAGG -> CTGGTCGCTGGGCCTAGGC
GCTGGTTCCAAAAACCGTT -> CTGGTTCCAAAAACCGTTT
GCTGTACATCCCGGGGAGG -> CTGTACATCCCGGGGAGGT
GCTGTTCCAATTTGCAGGT -> CTGTTCCAATTTGCAGGTC
GCTTATCGCACGCATGGAC -> CTTATCGCACGCATGGACG
GCTTCAAACAAGTTTATTC -> CTTCAAACAAGTTTATTCG
GCTTTCACTAGTTAACCCT -> CTTTCACTAGTTAACCCTA
GCTTTCATCTGTTGAGCTG -> CTTTCATCTGTTGAGCTGC
GCTTTCCGAGGCTCCGATT -> CTTTCCGAGGCTCCGATTA
GCTTTCTTCTGGTGAATAT -> CTTTCTTCTGGTGAATATA
GGAAAGTGAGACACAAGCT -> GAAAGTGAGACACAAGCTA
GGAAGGACCGGAGTGAAAG -> GAAGGACCGGAGTGAAAGA
GGAATATAGGCCTCTAGTC -> GAATATAGGCCTCTAGTCT
GGACAAACAGTCCTATAAT -> GACAAACAGTCCTATAATA
GGACAGAACACGATTCCAC -> GACAGAACACGATTCCACA
GGACCGGAGTGAAAGAACG -> GACCGGAGTGAAAGAACGA
GGACCGTATAATATCGCCC -> GACCGTATAATATCGCCCA
GGACGAAATTATACATGAG -> GACGAAATTATACATGAGT
GGACGTGGCGGCCGATTCC -> GACGTGGCGGCCGATTCCG
GGAGAAGGGACAAACAGTC -> GAGAAGGGACAAACAGTCC
GGAGGTGCCCTAGTGAGTA -> GAGGTGCCCTAGTGAGTAT
GGAGGTGCTCCGTTCGTTT -> GAGGTGCTCCGTTCGTTTG
GGAGGTTATGCAATGATAA -> GAGGTTATGCAATGATAAT
GGAGTAGACACCAACCCAC -> GAGTAGACACCAACCCACT
GGAGTGAAAGAACGAAACT -> GAGTGAAAGAACGAAACTC
GGAGTTTCGTCGTGCTCAG -> GAGTTTCGTCGTGCTCAGT
GGATAACGTGCTGCGAGTA -> GATAACGTGCTGCGAGTAT
GGATACTCCCTCTGAGTGT -> GATACTCCCTCTGAGTGTG
GGATCTTATCAATTGAGTC -> GATCTTATCAATTGAGTCC
GGATTATTTGTCACAATTA -> GATTATTTGTCACAATTAC
GGCACACTGCTACTCGGAG -> GCACACTGCTACTCGGAGG
GGCACCTTCTCATTGCGGT -> GCACCTTCTCATTGCGGTT
GGCAGACCCGTAACGATTT -> GCAGACCCGTAACGATTTA
GGCAGCGACAAAGTGAGAC -> GCAGCGACAAAGTGAGACA
GGCAGGTCGAACTACTTAA -> GCAGGTCGAACTACTTAAT
GGCAGTAAGAGTACACACA -> GCAGTAAGAGTACACACAG
GGCATAGTGCTCGTCGTGC -> GCATAGTGCTCGTCGTGCT
GGCATCTCTTTACGCAGTA -> GCATCTCTTTACGCAGTAC
GGCCAGAACGATGTTCGAA -> GCCAGAACGATGTTCGAAG
GGCCAGTACGCAGACTTTC -> GCCAGTACGCAGACTTTCC
GGCCCCCTGTCTGTAAGCA -> GCCCCCTGTCTGTAAGCAA
GGCCGATTCCGCTTTCATC -> GCCGATTCCGCTTTCATCT
GGCCGCTCCTTGGTACCTA -> GCCGCTCCTTGGTACCTAT
GGCCTAGGCAGACCCGTAA -> GCCTAGGCAGACCCGTAAC
GGCCTCTAGTCTTTTACCC -> GCCTCTAGTCTTTTACCCG
GGCCTTATTACATCATTGA -> GCCTTATTACATCATTGAC
GGCGACTACTGGGGGTGGT -> GCGACTACTGGGGGTGGTA
GGCGACTCGTACCTGCGAA -> GCGACTCGTACCTGCGAAG
GGCGAGACTATCCCCGTAT -> GCGAGACTATCCCCGTATA
GGCGAGTAATAGATAACTG -> GCGAGTAATAGATAACTGA
GGCGCGTGAGTGTGCAATA -> GCGCGTGAGTGTGCAATAC
GGCGGATTATTTGTCACAA -> GCGGATTATTTGTCACAAT
GGCGGCCGATTCCGCTTTC -> GCGGCCGATTCCGCTTTCA
GGCGTGAGCGACCTATACT -> GCGTGAGCGACCTATACTC
GGCTAAGCCCGGCCTTATT -> GCTAAGCCCGGCCTTATTA
GGCTAGCTTTCACTAGTTA -> GCTAGCTTTCACTAGTTAA
GGCTCAGCAAACGGGGTCC -> GCTCAGCAAACGGGGTCCT
GGCTCCGATTAGCATCGTA -> GCTCCGATTAGCATCGTAG
GGCTCGACAGGCGACTCGT -> GCTCGACAGGCGACTCGTA
GGCTGCGTACTGGTGCTCC -> GCTGCGTACTGGTGCTCCA
GGCTGTACATCCCGGGGAG -> GCTGTACATCCCGGGGAGG
GGCTGTTCCAATTTGCAGG -> GCTGTTCCAATTTGCAGGT
GGGACAAACAGTCCTATAA -> GGACAAACAGTCCTATAAT
GGGACAGAACACGATTCCA -> GGACAGAACACGATTCCAC
GGGACCGTATAATATCGCC -> GGACCGTATAATATCGCCC
GGGAGAAGGGACAAACAGT -> GGAGAAGGGACAAACAGTC
GGGAGGTGCTCCGTTCGTT -> GGAGGTGCTCCGTTCGTTT
GGGATAACGTGCTGCGAGT -> GGATAACGTGCTGCGAGTA
GGGATCTTATCAATTGAGT -> GGATCTTATCAATTGAGTC
GGGCACCTTCTCATTGCGG -> GGCACCTTCTCATTGCGGT
GGGCATAGTGCTCGTCGTG -> GGCATAGTGCTCGTCGTGC
GGGCATCTCTTTACGCAGT -> GGCATCTCTTTACGCAGTA
GGGCCAGTACGCAGACTTT -> GGCCAGTACGCAGACTTTC
GGGCCTAGGCAGACCCGTA -> GGCCTAGGCAGACCCGTAA
GGGCGCGTGAGTGTGCAAT -> GGCGCGTGAGTGTGCAATA
GGGGAGAAGGGACAAACAG -> GGGAGAAGGGACAAACAGT
GGGGAGGTGCTCCGTTCGT -> GGGAGGTGCTCCGTTCGTT
GGGGATAACGTGCTGCGAG -> GGGATAACGTGCTGCGAGT
GGGGGTGGTAATGTACTGT -> GGGGTGGTAATGTACTGTG
GGGGTCCTTAGTGAAAGAT -> GGGTCCTTAGTGAAAGATC
GGGGTGGTAATGTACTGTG -> GGGTGGTAATGTACTGTGG
GGGTAGATTTACCCTTAAT -> GGTAGATTTACCCTTAATT
GGGTCCTTAGTGAAAGATC -> GGTCCTTAGTGAAAGATCG
GGGTCTTGAATAAAGTGAG -> GGTCTTGAATAAAGTGAGA
GGGTGGTAATGTACTGTGG -> GGTGGTAATGTACTGTGGC
GGTAAGCGATAGGTGACAC -> GTAAGCGATAGGTGACACG
GGTAATGTACTGTGGCGAG -> GTAATGTACTGTGGCGAGT
GGTACCTATCCTGGCTGCG -> GTACCTATCCTGGCTGCGT
GGTACTCTGTTGGGTAGAT -> GTACTCTGTTGGGTAGATT
GGTAGAATTGGCACACTGC -> GTAGAATTGGCACACTGCT
GGTAGATTACACTACAAAA -> GTAGATTACACTACAAAAG
GGTAGATTTACCCTTAATT -> GTAGATTTACCCTTAATTT
GGTAGCACGACCTCCAAAT -> GTAGCACGACCTCCAAATC
GGTATCATCTCACAATGTA -> GTATCATCTCACAATGTAT
GGTCAATAAGGTTTATGAA -> GTCAATAAGGTTTATGAAG
GGTCCTTAGTGAAAGATCG -> GTCCTTAGTGAAAGATCGT
GGTCGAACTACTTAATTTT -> GTCGAACTACTTAATTTTC
GGTCGCTGGGCCTAGGCAG -> GTCGCTGGGCCTAGGCAGA
GGTCTGAAGGAGGTGCCCT -> GTCTGAAGGAGGTGCCCTA
GGTCTGCCGCTTTCTTCTG -> GTCTGCCGCTTTCTTCTGG
GGTCTTAGGGGATAACGTG -> GTCTTAGGGGATAACGTGC
GGTCTTGAATAAAGTGAGA -> GTCTTGAATAAAGTGAGAC
GGTGAATATAGAGGGCCAG -> GTGAATATAGAGGGCCAGT
GGTGACACGGTAGATTACA -> GTGACACGGTAGATTACAC
GGTGATCAACCAAAGCACC -> GTGATCAACCAAAGCACCC
GGTGATGCAGGGCGCGTGA -> GTGATGCAGGGCGCGTGAG
GGTGCCCTAGTGAGTATTC -> GTGCCCTAGTGAGTATTCT
GGTGCTCCAGGGCACCTTC -> GTGCTCCAGGGCACCTTCT
GGTGCTCCGTTCGTTTGAC -> GTGCTCCGTTCGTTTGACT
GGTGGCCCCCTGTCTGTAA -> GTGGCCCCCTGTCTGTAAG
GGTGGTAATGTACTGTGGC -> GTGGTAATGTACTGTGGCG
GGTGTACCCTTTTGGCAGC -> GTGTACCCTTTTGGCAGCG
GGTTAAAATCGTCGCTCGC -> GTTAAAATCGTCGCTCGCC
GGTTACGTTGAAGCATGGT -> GTTACGTTGAAGCATGGTT
GGTTACTCTGCTTATCGCA -> GTTACTCTGCTTATCGCAC
GGTTATGCAATGATAATTC -> GTTATGCAATGATAATTCA
GGTTCCAAAAACCGTTTTA -> GTTCCAAAAACCGTTTTAT
GGTTGGGGAGAAGGGACAA -> GTTGGGGAGAAGGGACAAA
GGTTTATGAAGATGAGTGT -> GTTTATGAAGATGAGTGTG
GTAAAACCACGGAAGGACC -> TAAAACCACGGAAGGACCG
GTAAAATGCCCCGGTCTTA -> TAAAATGCCCCGGTCTTAG
GTAACGATTTAGCTTCAAA -> TAACGATTTAGCTTCAAAC
GTAAGAGTACACACAGTGT -> TAAGAGTACACACAGTGTT
GTAAGATTTGACAGCTCCT -> TAAGATTTGACAGCTCCTA
GTAAGCAATTGCTGGTTCC -> TAAGCAATTGCTGGTTCCA
GTAAGCGATAGGTGACACG -> TAAGCGATAGGTGACACGG
GTAATAGATAACTGATGCC -> TAATAGATAACTGATGCCA
GTAATGTACTGTGGCGAGT -> TAATGTACTGTGGCGAGTA
GTACACACAGTGTTAATTT -> TACACACAGTGTTAATTTC
GTACAGCGCGTCGTCGTGC -> TACAGCGCGTCGTCGTGCT
GTACATCCCGGGGAGGTGC -> TACATCCCGGGGAGGTGCT
GTACCAAACGCCAGGGCAT -> TACCAAACGCCAGGGCATC
GTACCCTTTTGGCAGCGAC -> TACCCTTTTGGCAGCGACA
GTACCTATCCTGGCTGCGT -> TACCTATCCTGGCTGCGTA
GTACCTGCGAAGTACCAAA -> TACCTGCGAAGTACCAAAC
GTACGCAGACTTTCCCTTC -> TACGCAGACTTTCCCTTCG
GTACGGTGATGCAGGGCGC -> TACGGTGATGCAGGGCGCG
GTACTCCGCCCGATGTCGG -> TACTCCGCCCGATGTCGGG
GTACTCTGTTGGGTAGATT -> TACTCTGTTGGGTAGATTT
GTACTGGTGCTCCAGGGCA -> TACTGGTGCTCCAGGGCAC
GTACTGTGGCGAGTAATAG -> TACTGTGGCGAGTAATAGA
GTAGAATTGGCACACTGCT -> TAGAATTGGCACACTGCTA
GTAGACACCAACCCACTAA -> TAGACACCAACCCACTAAG
GTAGATTACACTACAAAAG -> TAGATTACACTACAAAAGA
GTAGATTTACCCTTAATTT -> TAGATTTACCCTTAATTTG
GTAGCACGACCTCCAAATC -> TAGCACGACCTCCAAATCG
GTAGCAGAGCAGTTCATGG -> TAGCAGAGCAGTTCATGGA
GTAGCCGGTAGCACGACCT -> TAGCCGGTAGCACGACCTC
GTAGCTCGACACTCCCAAC -> TAGCTCGACACTCCCAACT
GTATAATATCGCCCAAAGA -> TATAATATCGCCCAAAGAA
GTATAATGCCATTTGGCTA -> TATAATGCCATTTGGCTAA
GTATCATCTCACAATGTAT -> TATCATCTCACAATGTATG
GTATGAAGAGCCTTACGAT -> TATGAAGAGCCTTACGATT
GTATGAAGGACGTGGCGGC -> TATGAAGGACGTGGCGGCC
GTATGAAGGGACAGAACAC -> TATGAAGGGACAGAACACG
GTATGAATAATCTAGATAC -> TATGAATAATCTAGATACT
GTATGAGCCATGCCCCGGT -> TATGAGCCATGCCCCGGTA
GTATTACAGTCTATACTTC -> TATTACAGTCTATACTTCA
GTATTCTTGTCTCAAGCAC -> TATTCTTGTCTCAAGCACA
GTCAATAAGGTTTATGAAG -> TCAATAAGGTTTATGAAGA
GTCACAACTACGCGGTCTG -> TCACAACTACGCGGTCTGA
GTCACAATTACCAGCGCCT -> TCACAATTACCAGCGCCTC
GTCACTGACTCTTTGTCGC -> TCACTGACTCTTTGTCGCG
GTCATACTGCGCGTTGTTC -> TCATACTGCGCGTTGTTCG
GTCCCCCTCCTAATCCTAT -> TCCCCCTCCTAATCCTATT
GTCCGTAAGATTTGACAGC -> TCCGTAAGATTTGACAGCT
GTCCTATAATAACTCCGCC -> TCCTATAATAACTCCGCCG
GTCCTTAGTGAAAGATCGT -> TCCTTAGTGAAAGATCGTG
GTCGAACTACTTAATTTTC -> TCGAACTACTTAATTTTCC
GTCGATCTACTGACGGCTA -> TCGATCTACTGACGGCTAG
GTCGCGGTAAGCGATAGGT -> TCGCGGTAAGCGATAGGTG
GTCGCTCGCCGAGCAGTGT -> TCGCTCGCCGAGCAGTGTA
GTCGCTGGGCCTAGGCAGA -> TCGCTGGGCCTAGGCAGAC
GTCGGGTCTTGAATAAAGT -> TCGGGTCTTGAATAAAGTG
GTCGTCGTGCTCAGTATGA -> TCGTCGTGCTCAGTATGAA
GTCGTGCTCAGTATGAAGA -> TCGTGCTCAGTATGAAGAG
GTCGTGCTCAGTATGAAGG -> TCGTGCTCAGTATGAAGGA,TCGTGCTCAGTATGAAGGG
GTCGTGCTCAGTATGAATA -> TCGTGCTCAGTATGAATAA
GTCTATACTTCATGTCGAT -> TCTATACTTCATGTCGATC
GTCTCAAGCACACACCAAA -> TCTCAAGCACACACCAAAC
GTCTGAAGGAGGTGCCCTA -> TCTGAAGGAGGTGCCCTAG
GTCTGATGCGTAGCAGAGC -> TCTGATGCGTAGCAGAGCA
GTCTGCATCTGACGCTGGT -> TCTGCATCTGACGCTGGTC
GTCTGCCGCTTTCTTCTGG -> TCTGCCGCTTTCTTCTGGT
GTCTGTAAGCAATTGCTGG -> TCTGTAAGCAATTGCTGGT
GTCTTAGGGGATAACGTGC -> TCTTAGGGGATAACGTGCT
GTCTTGAATAAAGTGAGAC -> TCTTGAATAAAGTGAGACA
GTCTTTTACCCGAATTCCA -> TCTTTTACCCGAATTCCAT
GTGAAAAGTGAGACACAAG -> TGAAAAGTGAGACACAAGC
GTGAAAGAACGAAACTCGC -> TGAAAGAACGAAACTCGCC
GTGAAAGATCGTGGACGAA -> TGAAAGATCGTGGACGAAA
GTGAATATAGAGGGCCAGT -> TGAATATAGAGGGCCAGTA
GTGACACGGTAGATTACAC -> TGACACGGTAGATTACACT
GTGAGACACAAGCTAAGCT -> TGAGACACAAGCTAAGCTA
GTGAGACACAAGCTACCAC -> TGAGACACAAGCTACCACT
GTGAGACACAAGCTAGGGC -> TGAGACACAAGCTAGGGCA
GTGAGACACAAGCTATGTA -> TGAGACACAAGCTATGTAC
GTGAGCGACCTATACTCAT -> TGAGCGACCTATACTCATG
GTGAGGCAGGTCGAACTAC -> TGAGGCAGGTCGAACTACT
GTGAGTATTCTTGTCTCAA -> TGAGTATTCTTGTCTCAAG
GTGAGTGTGCAATACGAGA -> TGAGTGTGCAATACGAGAA
GTGATCAACCAAAGCACCC -> TGATCAACCAAAGCACCCG
GTGATCGTAAAACCACGGA -> TGATCGTAAAACCACGGAA
GTGATGCAGGGCGCGTGAG -> TGATGCAGGGCGCGTGAGT
GTGCAATACGAGAACACTA -> TGCAATACGAGAACACTAG
GTGCCCGCCTCGAGCAGGT -> TGCCCGCCTCGAGCAGGTC
GTGCCCTAGTGAGTATTCT -> TGCCCTAGTGAGTATTCTT
GTGCTAGAGCCATATTGAC -> TGCTAGAGCCATATTGACC
GTGCTCAGTATGAAGAGCC -> TGCTCAGTATGAAGAGCCT
GTGCTCAGTATGAAGGACG -> TGCTCAGTATGAAGGACGT
GTGCTCAGTATGAAGGGAC -> TGCTCAGTATGAAGGGACA
GTGCTCAGTATGAATAATC -> TGCTCAGTATGAATAATCT
GTGCTCCAGGGCACCTTCT -> TGCTCCAGGGCACCTTCTC
GTGCTCCGTTCGTTTGACT -> TGCTCCGTTCGTTTGACTG
GTGCTCGTCGTGCTCAGTA -> TGCTCGTCGTGCTCAGTAT
GTGCTGCGAGTATTACAGT -> TGCTGCGAGTATTACAGTC
GTGGACGAAATTATACATG -> TGGACGAAATTATACATGA
GTGGCCCCCTGTCTGTAAG -> TGGCCCCCTGTCTGTAAGC
GTGGCGAGTAATAGATAAC -> TGGCGAGTAATAGATAACT
GTGGCGGCCGATTCCGCTT -> TGGCGGCCGATTCCGCTTT
GTGGCTCAGCAAACGGGGT -> TGGCTCAGCAAACGGGGTC
GTGGCTCGACAGGCGACTC -> TGGCTCGACAGGCGACTCG
GTGGTAATGTACTGTGGCG -> TGGTAATGTACTGTGGCGA
GTGTACCCTTTTGGCAGCG -> TGTACCCTTTTGGCAGCGA
GTGTAGCTCGACACTCCCA -> TGTAGCTCGACACTCCCAA
GTGTGAAAAGTGAGACACA -> TGTGAAAAGTGAGACACAA
GTGTGCAATACGAGAACAC -> TGTGCAATACGAGAACACT
GTGTGGCTCAGCAAACGGG -> TGTGGCTCAGCAAACGGGG
GTGTTAATTTCAACCTGTG -> TGTTAATTTCAACCTGTGA
GTGTTCCATAATTGTCTGC -> TGTTCCATAATTGTCTGCA
GTTAAAATCGTCGCTCGCC -> TTAAAATCGTCGCTCGCCG
GTTAACCCTACCGTTCTGT -> TTAACCCTACCGTTCTGTG
GTTAAGGTTACGTTGAAGC -> TTAAGGTTACGTTGAAGCA
GTTAATTTCAACCTGTGAT -> TTAATTTCAACCTGTGATC
GTTACGTTGAAGCATGGTT -> TTACGTTGAAGCATGGTTA
GTTACTCAGTTTAAACTGC -> TTACTCAGTTTAAACTGCT
GTTACTCTGCTTATCGCAC -> TTACTCTGCTTATCGCACG
GTTATAGGCCAGAACGATG -> TTATAGGCCAGAACGATGT
GTTATGCAATGATAATTCA -> TTATGCAATGATAATTCAC
GTTCATGGAAAGTGAGACA -> TTCATGGAAAGTGAGACAC
GTTCCAAAAACCGTTTTAT -> TTCCAAAAACCGTTTTATT
GTTCCAACCTGCGGCGACT -> TTCCAACCTGCGGCGACTA
GTTCCAATTTGCAGGTCAA -> TTCCAATTTGCAGGTCAAT
GTTCCATAATTGTCTGCAT -> TTCCATAATTGTCTGCATC
GTTCGAAGAACGATAGTGC -> TTCGAAGAACGATAGTGCC
GTTCGGATACTCCCTCTGA -> TTCGGATACTCCCTCTGAG
GTTCGTTTGACTGGCCGCT -> TTCGTTTGACTGGCCGCTC
GTTCTGTGGCTCGACAGGC -> TTCTGTGGCTCGACAGGCG
GTTGAAGCATGGTTAAAAT -> TTGAAGCATGGTTAAAATC
GTTGAGCTGCGGAATATAG -> TTGAGCTGCGGAATATAGG
GTTGGGGAGAAGGGACAAA -> TTGGGGAGAAGGGACAAAC
GTTGGGTAGATTTACCCTT -> TTGGGTAGATTTACCCTTA
GTTGTTCGGATACTCCCTC -> TTGTTCGGATACTCCCTCT
GTTTAAACTGCTACCATCG -> TTTAAACTGCTACCATCGG
GTTTATGAAGATGAGTGTG -> TTTATGAAGATGAGTGTGA
GTTTATTCGGTGTACCCTT -> TTTATTCGGTGTACCCTTT
GTTTCGTCGTGCTCAGTAT -> TTTCGTCGTGCTCAGTATG
GTTTGACTGGCCGCTCCTT -> TTTGACTGGCCGCTCCTTG
GTTTTATTGTTATAGGCCA -> TTTTATTGTTATAGGCCAG
TAAAAATACAGTCTGATGC -> AAAAATACAGTCTGATGCG
TAAAACCACGGAAGGACCG -> AAAACCACGGAAGGACCGG
TAAAATCGTCGCTCGCCGA -> AAAATCGTCGCTCGCCGAG
TAAAATGCCCCGGTCTTAG -> AAAATGCCCCGGTCTTAGG
TAAACTGCTACCATCGGGA -> AAACTGCTACCATCGGGAT
TAAAGGCGGATTATTTGTC -> AAAGGCGGATTATTTGTCA
TAAAGTGAGACACAAGCTA -> AAAGTGAGACACAAGCTAT
TAAATTCTGTCACTGACTC -> AAATTCTGTCACTGACTCT
TAACCCTACCGTTCTGTGG -> AACCCTACCGTTCTGTGGC
TAACCCTACCTCCGGTAGA -> AACCCTACCTCCGGTAGAA
TAACGATTTAGCTTCAAAC -> AACGATTTAGCTTCAAACA
TAACGCGGCTGTTCCAATT -> AACGCGGCTGTTCCAATTT
TAACGTGCTGCGAGTATTA -> AACGTGCTGCGAGTATTAC
TAACTCCGCCGATGAAGTA -> AACTCCGCCGATGAAGTAA
TAACTGATGCCAGATTATA -> AACTGATGCCAGATTATAA
TAAGAGTACACACAGTGTT -> AAGAGTACACACAGTGTTA
TAAGATTTGACAGCTCCTA -> AAGATTTGACAGCTCCTAG
TAAGCAATTGCTGGTTCCA -> AAGCAATTGCTGGTTCCAA
TAAGCCCGGCCTTATTACA -> AAGCCCGGCCTTATTACAT
TAAGCGATAGGTGACACGG -> AAGCGATAGGTGACACGGT
TAAGCTAGGAGTTTCGTCG -> AAGCTAGGAGTTTCGTCGT
TAAGGGACCGTATAATATC -> AAGGGACCGTATAATATCG
TAAGGTTACGTTGAAGCAT -> AAGGTTACGTTGAAGCATG
TAAGGTTTATGAAGATGAG -> AAGGTTTATGAAGATGAGT
TAATAACTCCGCCGATGAA -> AATAACTCCGCCGATGAAG
TAATAGATAACTGATGCCA -> AATAGATAACTGATGCCAG
TAATATCGCCCAAAGAATA -> AATATCGCCCAAAGAATAA
TAATCCTATTCAATGAGCG -> AATCCTATTCAATGAGCGC
TAATCTAGATACTTTGGTA -> AATCTAGATACTTTGGTAT
TAATGCCATTTGGCTAAGC -> AATGCCATTTGGCTAAGCC
TAATGTACTGTGGCGAGTA -> AATGTACTGTGGCGAGTAA
TAATTCACAGGAGTAGACA -> AATTCACAGGAGTAGACAC
TAATTGTCTGCATCTGACG -> AATTGTCTGCATCTGACGC
TAATTTCAACCTGTGATCG -> AATTTCAACCTGTGATCGT
TAATTTGATATCGTCATAC -> AATTTGATATCGTCATACT
TAATTTTCCCTACCCCAAC -> AATTTTCCCTACCCCAACA
TACAAAAGAAATTTGGCGT -> ACAAAAGAAATTTGGCGTG
TACACACAGTGTTAATTTC -> ACACACAGTGTTAATTTCA
TACACTACAAAAGAAATTT -> ACACTACAAAAGAAATTTG
TACACTTGTACGGTGATGC -> ACACTTGTACGGTGATGCA
TACAGCGCGTCGTCGTGCT -> ACAGCGCGTCGTCGTGCTC
TACAGTCTATACTTCATGT -> ACAGTCTATACTTCATGTC
TACAGTCTGATGCGTAGCA -> ACAGTCTGATGCGTAGCAG
TACATCATTGACAGATGGC -> ACATCATTGACAGATGGCA
TACATCCCGGGGAGGTGCT -> ACATCCCGGGGAGGTGCTC
TACATGAGTGTTCCATAAT -> ACATGAGTGTTCCATAATT
TACCAAACGCCAGGGCATC -> ACCAAACGCCAGGGCATCT
TACCACTTTGCGATCGTCG -> ACCACTTTGCGATCGTCGT
TACCAGCGCCTCGACATGA -> ACCAGCGCCTCGACATGAA
TACCATCAGCTTTCCGAGG -> ACCATCAGCTTTCCGAGGC
TACCATCGGGATCTTATCA -> ACCATCGGGATCTTATCAA
TACCCCAACATAGTTACTC -> ACCCCAACATAGTTACTCA
TACCCGAATTCCATTGCGA -> ACCCGAATTCCATTGCGAC
TACCCTTAATTTGATATCG -> ACCCTTAATTTGATATCGT
TACCCTTTTGGCAGCGACA -> ACCCTTTTGGCAGCGACAA
TACCGTTCTGTGGCTCGAC -> ACCGTTCTGTGGCTCGACA
TACCTATCCTGGCTGCGTA -> ACCTATCCTGGCTGCGTAC
TACCTCCGGTAGAATTGGC -> ACCTCCGGTAGAATTGGCA
TACCTGCGAAGTACCAAAC -> ACCTGCGAAGTACCAAACG
TACGAGAACACTAGCATAG -> ACGAGAACACTAGCATAGC
TACGATTCGACAAGATGAC -> ACGATTCGACAAGATGACG
TACGCAGACTTTCCCTTCG -> ACGCAGACTTTCCCTTCGA
TACGCAGTACTCCGCCCGA -> ACGCAGTACTCCGCCCGAT
TACGCGGTCTGAAGGAGGT -> ACGCGGTCTGAAGGAGGTG
TACGGTGATGCAGGGCGCG -> ACGGTGATGCAGGGCGCGT
TACGTTGAAGCATGGTTAA -> ACGTTGAAGCATGGTTAAA
TACTCAGTTTAAACTGCTA -> ACTCAGTTTAAACTGCTAC
TACTCATGGCGAGACTATC -> ACTCATGGCGAGACTATCC
TACTCCCTCTGAGTGTGGC -> ACTCCCTCTGAGTGTGGCT
TACTCCGCCCGATGTCGGG -> ACTCCGCCCGATGTCGGGT
TACTCGGAGGTTATGCAAT -> ACTCGGAGGTTATGCAATG
TACTCTGCTTATCGCACGC -> ACTCTGCTTATCGCACGCA
TACTCTGTTGGGTAGATTT -> ACTCTGTTGGGTAGATTTA
TACTGACGGCTAGCTTTCA -> ACTGACGGCTAGCTTTCAC
TACTGCGCGTTGTTCGGAT -> ACTGCGCGTTGTTCGGATA
TACTGGGGGTGGTAATGTA -> ACTGGGGGTGGTAATGTAC
TACTGGTGCTCCAGGGCAC -> ACTGGTGCTCCAGGGCACC
TACTGTGGCGAGTAATAGA -> ACTGTGGCGAGTAATAGAT
TACTTAATTTTCCCTACCC -> ACTTAATTTTCCCTACCCC
TACTTCATGTCGATCTACT -> ACTTCATGTCGATCTACTG
TACTTTGGTATCATCTCAC -> ACTTTGGTATCATCTCACA
TAGAAGTGAGGCAGGTCGA -> AGAAGTGAGGCAGGTCGAA
TAGAATTGGCACACTGCTA -> AGAATTGGCACACTGCTAC
TAGACACCAACCCACTAAG -> AGACACCAACCCACTAAGG
TAGAGCCATATTGACCAAT -> AGAGCCATATTGACCAATT
TAGAGGGCCAGTACGCAGA -> AGAGGGCCAGTACGCAGAC
TAGATAAAGGCGGATTATT -> AGATAAAGGCGGATTATTT
TAGATAACTGATGCCAGAT -> AGATAACTGATGCCAGATT
TAGATACTTTGGTATCATC -> AGATACTTTGGTATCATCT
TAGATTACACTACAAAAGA -> AGATTACACTACAAAAGAA
TAGATTTACCCTTAATTTG -> AGATTTACCCTTAATTTGA
TAGCACGACCTCCAAATCG -> AGCACGACCTCCAAATCGC
TAGCAGACCCCCGCAACCT -> AGCAGACCCCCGCAACCTT
TAGCAGAGCAGTTCATGGA -> AGCAGAGCAGTTCATGGAA
TAGCATAGCGACATTTAGC -> AGCATAGCGACATTTAGCA
TAGCATCGTAGCCGGTAGC -> AGCATCGTAGCCGGTAGCA
TAGCCGGTAGCACGACCTC -> AGCCGGTAGCACGACCTCC
TAGCGACATTTAGCAGACC -> AGCGACATTTAGCAGACCC
TAGCTCGACACTCCCAACT -> AGCTCGACACTCCCAACTG
TAGCTTCAAACAAGTTTAT -> AGCTTCAAACAAGTTTATT
TAGCTTTCACTAGTTAACC -> AGCTTTCACTAGTTAACCC
TAGGAGTTTCGTCGTGCTC -> AGGAGTTTCGTCGTGCTCA
TAGGCAGACCCGTAACGAT -> AGGCAGACCCGTAACGATT
TAGGCCAGAACGATGTTCG -> AGGCCAGAACGATGTTCGA
TAGGCCTCTAGTCTTTTAC -> AGGCCTCTAGTCTTTTACC
TAGGGCATAGTGCTCGTCG -> AGGGCATAGTGCTCGTCGT
TAGGGGATAACGTGCTGCG -> AGGGGATAACGTGCTGCGA
TAGGTGACACGGTAGATTA -> AGGTGACACGGTAGATTAC
TAGGTTACTCTGCTTATCG -> AGGTTACTCTGCTTATCGC
TAGTCACAACTACGCGGTC -> AGTCACAACTACGCGGTCT
TAGTCCGTAAGATTTGACA -> AGTCCGTAAGATTTGACAG
TAGTCTTTTACCCGAATTC -> AGTCTTTTACCCGAATTCC
TAGTGAAAGATCGTGGACG -> AGTGAAAGATCGTGGACGA
TAGTGAGTATTCTTGTCTC -> AGTGAGTATTCTTGTCTCA
TAGTGCCCGCCTCGAGCAG -> AGTGCCCGCCTCGAGCAGG
TAGTGCTCGTCGTGCTCAG -> AGTGCTCGTCGTGCTCAGT
TAGTTAACCCTACCGTTCT -> AGTTAACCCTACCGTTCTG
TAGTTACTCAGTTTAAACT -> AGTTACTCAGTTTAAACTG
TATAACCCTACCTCCGGTA -> ATAACCCTACCTCCGGTAG
TATAATAACTCCGCCGATG -> ATAATAACTCCGCCGATGA
TATAATATCGCCCAAAGAA -> ATAATATCGCCCAAAGAAT
TATAATGCCATTTGGCTAA -> ATAATGCCATTTGGCTAAG
TATACATGAGTGTTCCATA -> ATACATGAGTGTTCCATAA
TATACTCATGGCGAGACTA -> ATACTCATGGCGAGACTAT
TATACTTCATGTCGATCTA -> ATACTTCATGTCGATCTAC
TATAGAGGGCCAGTACGCA -> ATAGAGGGCCAGTACGCAG
TATAGGCCAGAACGATGTT -> ATAGGCCAGAACGATGTTC
TATAGGCCTCTAGTCTTTT -> ATAGGCCTCTAGTCTTTTA
TATCAATTGAGTCCCCCTC -> ATCAATTGAGTCCCCCTCC
TATCATCTCACAATGTATG -> ATCATCTCACAATGTATGA
TATCCCCGTATAATGCCAT -> ATCCCCGTATAATGCCATT
TATCCTGGCTGCGTACTGG -> ATCCTGGCTGCGTACTGGT
TATCGCCCAAAGAATAACG -> ATCGCCCAAAGAATAACGC
TATCGTCATACTGCGCGTT -> ATCGTCATACTGCGCGTTG
TATGAAGAGCCTTACGATT -> ATGAAGAGCCTTACGATTC
TATGAAGATGAGTGTGAAA -> ATGAAGATGAGTGTGAAAA
TATGAAGGACGTGGCGGCC -> ATGAAGGACGTGGCGGCCG
TATGAAGGGACAGAACACG -> ATGAAGGGACAGAACACGA
TATGAATAATCTAGATACT -> ATGAATAATCTAGATACTT
TATGAGCCATGCCCCGGTA -> ATGAGCCATGCCCCGGTAC
TATGCAATGATAATTCACA -> ATGCAATGATAATTCACAG
TATGTACAGCGCGTCGTCG -> ATGTACAGCGCGTCGTCGT
TATTACAGTCTATACTTCA -> ATTACAGTCTATACTTCAT
TATTACATCATTGACAGAT -> ATTACATCATTGACAGATG
TATTCAATGAGCGCCCGAT -> ATTCAATGAGCGCCCGATA
TATTCGGTGTACCCTTTTG -> ATTCGGTGTACCCTTTTGG
TATTCTTGTCTCAAGCACA -> ATTCTTGTCTCAAGCACAC
TATTGACCAATTTGTTCCA -> ATTGACCAATTTGTTCCAA
TATTGTTATAGGCCAGAAC -> ATTGTTATAGGCCAGAACG
TATTTGTCACAATTACCAG -> ATTTGTCACAATTACCAGC
TCAAACAAGTTTATTCGGT -> CAAACAAGTTTATTCGGTG
TCAACCAAAGCACCCGCAC -> CAACCAAAGCACCCGCACT
TCAACCTGTGATCGTAAAA -> CAACCTGTGATCGTAAAAC
TCAACGGCTGTACATCCCG -> CAACGGCTGTACATCCCGG
TCAAGATTAAAAATACAGT -> CAAGATTAAAAATACAGTC
TCAAGCACACACCAAACGA -> CAAGCACACACCAAACGAG
TCAATAAGGTTTATGAAGA -> CAATAAGGTTTATGAAGAT
TCAATGAGCGCCCGATAGG -> CAATGAGCGCCCGATAGGT
TCAATTGAGTCCCCCTCCT -> CAATTGAGTCCCCCTCCTA
TCACAACTACGCGGTCTGA -> CACAACTACGCGGTCTGAA
TCACAATGTATGAGCCATG -> CACAATGTATGAGCCATGC
TCACAATTACCAGCGCCTC -> CACAATTACCAGCGCCTCG
TCACAGGAGTAGACACCAA -> CACAGGAGTAGACACCAAC
TCACTAGTTAACCCTACCG -> CACTAGTTAACCCTACCGT
TCACTGACTCTTTGTCGCG -> CACTGACTCTTTGTCGCGG
TCAGCAAACGGGGTCCTTA -> CAGCAAACGGGGTCCTTAG
TCAGCTTTCCGAGGCTCCG -> CAGCTTTCCGAGGCTCCGA
TCAGTATGAAGAGCCTTAC -> CAGTATGAAGAGCCTTACG
TCAGTATGAAGGACGTGGC -> CAGTATGAAGGACGTGGCG
TCAGTATGAAGGGACAGAA -> CAGTATGAAGGGACAGAAC
TCAGTATGAATAATCTAGA -> CAGTATGAATAATCTAGAT
TCAGTTAAGGTTACGTTGA -> CAGTTAAGGTTACGTTGAA
TCAGTTTAAACTGCTACCA -> CAGTTTAAACTGCTACCAT
TCATACTGCGCGTTGTTCG -> CATACTGCGCGTTGTTCGG
TCATCTCACAATGTATGAG -> CATCTCACAATGTATGAGC
TCATCTGTTGAGCTGCGGA -> CATCTGTTGAGCTGCGGAA
TCATGGAAAGTGAGACACA -> CATGGAAAGTGAGACACAA
TCATGGCGAGACTATCCCC -> CATGGCGAGACTATCCCCG
TCATGTCGATCTACTGACG -> CATGTCGATCTACTGACGG
TCATTGACAGATGGCAGTA -> CATTGACAGATGGCAGTAA
TCATTGCGGTTGGGGAGAA -> CATTGCGGTTGGGGAGAAG
TCCAAAAACCGTTTTATTG -> CCAAAAACCGTTTTATTGT
TCCAAATCGCCGATAGTCC -> CCAAATCGCCGATAGTCCG
TCCAACCTGCGGCGACTAC -> CCAACCTGCGGCGACTACT
TCCAATTTGCAGGTCAATA -> CCAATTTGCAGGTCAATAA
TCCACATTAGATAAAGGCG -> CCACATTAGATAAAGGCGG
TCCAGGGCACCTTCTCATT -> CCAGGGCACCTTCTCATTG
TCCATAATTGTCTGCATCT -> CCATAATTGTCTGCATCTG
TCCATTGCGACTAGTCACA -> CCATTGCGACTAGTCACAA
TCCCAACTGCATAAATTCT -> CCCAACTGCATAAATTCTG
TCCCCCTCCTAATCCTATT -> CCCCCTCCTAATCCTATTC
TCCCCGTATAATGCCATTT -> CCCCGTATAATGCCATTTG
TCCCGGGGAGGTGCTCCGT -> CCCGGGGAGGTGCTCCGTT
TCCCTACCCCAACATAGTT -> CCCTACCCCAACATAGTTA
TCCCTCTGAGTGTGGCTCA -> CCCTCTGAGTGTGGCTCAG
TCCCTTCGAGCTACCATCA -> CCCTTCGAGCTACCATCAG
TCCGAGGCTCCGATTAGCA -> CCGAGGCTCCGATTAGCAT
TCCGATTAGCATCGTAGCC -> CCGATTAGCATCGTAGCCG
TCCGCCCGATGTCGGGTCT -> CCGCCCGATGTCGGGTCTT
TCCGCCGATGAAGTAAAAT -> CCGCCGATGAAGTAAAATG
TCCGCTTTCATCTGTTGAG -> CCGCTTTCATCTGTTGAGC
TCCGGTAGAATTGGCACAC -> CCGGTAGAATTGGCACACT
TCCGTAAGATTTGACAGCT -> CCGTAAGATTTGACAGCTC
TCCGTTCGTTTGACTGGCC -> CCGTTCGTTTGACTGGCCG
TCCTAATCCTATTCAATGA -> CCTAATCCTATTCAATGAG
TCCTAGAAGTGAGGCAGGT -> CCTAGAAGTGAGGCAGGTC
TCCTATAATAACTCCGCCG -> CCTATAATAACTCCGCCGA
TCCTATTCAATGAGCGCCC -> CCTATTCAATGAGCGCCCG
TCCTCAACGGCTGTACATC -> CCTCAACGGCTGTACATCC
TCCTGGCTGCGTACTGGTG -> CCTGGCTGCGTACTGGTGC
TCCTTAGTGAAAGATCGTG -> CCTTAGTGAAAGATCGTGG
TCCTTGGTACCTATCCTGG -> CCTTGGTACCTATCCTGGC
TCGAACTACTTAATTTTCC -> CGAACTACTTAATTTTCCC
TCGAAGAACGATAGTGCCC -> CGAAGAACGATAGTGCCCG
TCGACAAGATGACGAGAAT -> CGACAAGATGACGAGAATG
TCGACACTCCCAACTGCAT -> CGACACTCCCAACTGCATA
TCGACAGGCGACTCGTACC -> CGACAGGCGACTCGTACCT
TCGACATGAAGATCAGTTA -> CGACATGAAGATCAGTTAA
TCGAGCAGGTCTGCCGCTT -> CGAGCAGGTCTGCCGCTTT
TCGAGCTACCATCAGCTTT -> CGAGCTACCATCAGCTTTC
TCGATCTACTGACGGCTAG -> CGATCTACTGACGGCTAGC
TCGCCCAAAGAATAACGCG -> CGCCCAAAGAATAACGCGG
TCGCCGAGCAGTGTAGCTC -> CGCCGAGCAGTGTAGCTCG
TCGCCGATAGTCCGTAAGA -> CGCCGATAGTCCGTAAGAT
TCGCCGGTGATCAACCAAA -> CGCCGGTGATCAACCAAAG
TCGCGGTAAGCGATAGGTG -> CGCGGTAAGCGATAGGTGA
TCGCTCGCCGAGCAGTGTA -> CGCTCGCCGAGCAGTGTAG
TCGCTGGGCCTAGGCAGAC -> CGCTGGGCCTAGGCAGACC
TCGGAGGTTATGCAATGAT -> CGGAGGTTATGCAATGATA
TCGGATACTCCCTCTGAGT -> CGGATACTCCCTCTGAGTG
TCGGGATCTTATCAATTGA -> CGGGATCTTATCAATTGAG
TCGGGTCTTGAATAAAGTG -> CGGGTCTTGAATAAAGTGA
TCGGTGTACCCTTTTGGCA -> CGGTGTACCCTTTTGGCAG
TCGTAAAACCACGGAAGGA -> CGTAAAACCACGGAAGGAC
TCGTACCTGCGAAGTACCA -> CGTACCTGCGAAGTACCAA
TCGTAGCCGGTAGCACGAC -> CGTAGCCGGTAGCACGACC
TCGTCATACTGCGCGTTGT -> CGTCATACTGCGCGTTGTT
TCGTCGCTCGCCGAGCAGT -> CGTCGCTCGCCGAGCAGTG
TCGTCGTGCTCAGTATGAA -> CGTCGTGCTCAGTATGAAG,CGTCGTGCTCAGTATGAAG,CGTCGTGCTCAGTATGAAT,CGTCGTGCTCAGTATGAAG
TCGTGCTCAGTATGAAGAG -> CGTGCTCAGTATGAAGAGC
TCGTGCTCAGTATGAAGGA -> CGTGCTCAGTATGAAGGAC
TCGTGCTCAGTATGAAGGG -> CGTGCTCAGTATGAAGGGA
TCGTGCTCAGTATGAATAA -> CGTGCTCAGTATGAATAAT
TCGTGGACGAAATTATACA -> CGTGGACGAAATTATACAT
TCGTTTGACTGGCCGCTCC -> CGTTTGACTGGCCGCTCCT
TCTACTGACGGCTAGCTTT -> CTACTGACGGCTAGCTTTC
TCTAGATACTTTGGTATCA -> CTAGATACTTTGGTATCAT
TCTAGTCTTTTACCCGAAT -> CTAGTCTTTTACCCGAATT
TCTATACTTCATGTCGATC -> CTATACTTCATGTCGATCT
TCTCAAGCACACACCAAAC -> CTCAAGCACACACCAAACG
TCTCACAATGTATGAGCCA -> CTCACAATGTATGAGCCAT
TCTCATTGCGGTTGGGGAG -> CTCATTGCGGTTGGGGAGA
TCTCTTTACGCAGTACTCC -> CTCTTTACGCAGTACTCCG
TCTGAAGGAGGTGCCCTAG -> CTGAAGGAGGTGCCCTAGT
TCTGACGCTGGTCGCTGGG -> CTGACGCTGGTCGCTGGGC
TCTGAGTGTGGCTCAGCAA -> CTGAGTGTGGCTCAGCAAA
TCTGATGCGTAGCAGAGCA -> CTGATGCGTAGCAGAGCAG
TCTGCATCTGACGCTGGTC -> CTGCATCTGACGCTGGTCG
TCTGCCGCTTTCTTCTGGT -> CTGCCGCTTTCTTCTGGTG
TCTGCTTATCGCACGCATG -> CTGCTTATCGCACGCATGG
TCTGGTGAATATAGAGGGC -> CTGGTGAATATAGAGGGCC
TCTGTAAGCAATTGCTGGT -> CTGTAAGCAATTGCTGGTT
TCTGTCACTGACTCTTTGT -> CTGTCACTGACTCTTTGTC
TCTGTGGCTCGACAGGCGA -> CTGTGGCTCGACAGGCGAC
TCTGTTGAGCTGCGGAATA -> CTGTTGAGCTGCGGAATAT
TCTGTTGGGTAGATTTACC -> CTGTTGGGTAGATTTACCC
TCTTAGGGGATAACGTGCT -> CTTAGGGGATAACGTGCTG
TCTTATCAATTGAGTCCCC -> CTTATCAATTGAGTCCCCC
TCTTCTGGTGAATATAGAG -> CTTCTGGTGAATATAGAGG
TCTTGAATAAAGTGAGACA -> CTTGAATAAAGTGAGACAC
TCTTGTCTCAAGCACACAC -> CTTGTCTCAAGCACACACC
TCTTTACGCAGTACTCCGC -> CTTTACGCAGTACTCCGCC
TCTTTGTCGCGGTAAGCGA -> CTTTGTCGCGGTAAGCGAT
TCTTTTACCCGAATTCCAT -> CTTTTACCCGAATTCCATT
TGAAAAGTGAGACACAAGC -> GAAAAGTGAGACACAAGCT
TGAAAGAACGAAACTCGCC -> GAAAGAACGAAACTCGCCG
TGAAAGATCGTGGACGAAA -> GAAAGATCGTGGACGAAAT
TGAAGAGCCTTACGATTCG -> GAAGAGCCTTACGATTCGA
TGAAGATCAGTTAAGGTTA -> GAAGATCAGTTAAGGTTAC
TGAAGATGAGTGTGAAAAG -> GAAGATGAGTGTGAAAAGT
TGAAGCATGGTTAAAATCG -> GAAGCATGGTTAAAATCGT
TGAAGGACGTGGCGGCCGA -> GAAGGACGTGGCGGCCGAT
TGAAGGAGGTGCCCTAGTG -> GAAGGAGGTGCCCTAGTGA
TGAAGGGACAGAACACGAT -> GAAGGGACAGAACACGATT
TGAAGTAAAATGCCCCGGT -> GAAGTAAAATGCCCCGGTC
TGAATAAAGTGAGACACAA -> GAATAAAGTGAGACACAAG
TGAATAATCTAGATACTTT -> GAATAATCTAGATACTTTG
TGAATATAGAGGGCCAGTA -> GAATATAGAGGGCCAGTAC
TGACACGGTAGATTACACT -> GACACGGTAGATTACACTA
TGACAGATGGCAGTAAGAG -> GACAGATGGCAGTAAGAGT
TGACAGCTCCTAGAAGTGA -> GACAGCTCCTAGAAGTGAG
TGACCAATTTGTTCCAACC -> GACCAATTTGTTCCAACCT
TGACGAGAATGATCCTCAA -> GACGAGAATGATCCTCAAC
TGACGCTGGTCGCTGGGCC -> GACGCTGGTCGCTGGGCCT
TGACGGCTAGCTTTCACTA -> GACGGCTAGCTTTCACTAG
TGACTCTTTGTCGCGGTAA -> GACTCTTTGTCGCGGTAAG
TGACTGGCCGCTCCTTGGT -> GACTGGCCGCTCCTTGGTA
TGAGACACAAGCTAAGCTA -> GAGACACAAGCTAAGCTAG
TGAGACACAAGCTACCACT -> GAGACACAAGCTACCACTT
TGAGACACAAGCTAGGGCA -> GAGACACAAGCTAGGGCAT
TGAGACACAAGCTATGTAC -> GAGACACAAGCTATGTACA
TGAGCCATGCCCCGGTACT -> GAGCCATGCCCCGGTACTC
TGAGCGACCTATACTCATG -> GAGCGACCTATACTCATGG
TGAGCGCCCGATAGGTTAC -> GAGCGCCCGATAGGTTACT
TGAGCTGCGGAATATAGGC -> GAGCTGCGGAATATAGGCC
TGAGGCAGGTCGAACTACT -> GAGGCAGGTCGAACTACTT
TGAGTATTCTTGTCTCAAG -> GAGTATTCTTGTCTCAAGC
TGAGTCCCCCTCCTAATCC -> GAGTCCCCCTCCTAATCCT
TGAGTGTGAAAAGTGAGAC -> GAGTGTGAAAAGTGAGACA
TGAGTGTGCAATACGAGAA -> GAGTGTGCAATACGAGAAC
TGAGTGTGGCTCAGCAAAC -> GAGTGTGGCTCAGCAAACG
TGAGTGTTCCATAATTGTC -> GAGTGTTCCATAATTGTCT
TGATAATTCACAGGAGTAG -> GATAATTCACAGGAGTAGA
TGATATCGTCATACTGCGC -> GATATCGTCATACTGCGCG
TGATCAACCAAAGCACCCG -> GATCAACCAAAGCACCCGC
TGATCCTCAACGGCTGTAC -> GATCCTCAACGGCTGTACA
TGATCGTAAAACCACGGAA -> GATCGTAAAACCACGGAAG
TGATGCAGGGCGCGTGAGT -> GATGCAGGGCGCGTGAGTG
TGATGCCAGATTATAACCC -> GATGCCAGATTATAACCCT
TGATGCGTAGCAGAGCAGT -> GATGCGTAGCAGAGCAGTT
TGCAATACGAGAACACTAG -> GCAATACGAGAACACTAGC
TGCAATGATAATTCACAGG -> GCAATGATAATTCACAGGA
TGCAGGGCGCGTGAGTGTG -> GCAGGGCGCGTGAGTGTGC
TGCAGGTCAATAAGGTTTA -> GCAGGTCAATAAGGTTTAT
TGCATAAATTCTGTCACTG -> GCATAAATTCTGTCACTGA
TGCATCTGACGCTGGTCGC -> GCATCTGACGCTGGTCGCT
TGCCAGATTATAACCCTAC -> GCCAGATTATAACCCTACC
TGCCATTTGGCTAAGCCCG -> GCCATTTGGCTAAGCCCGG
TGCCCCGGTACTCTGTTGG -> GCCCCGGTACTCTGTTGGG
TGCCCCGGTCTTAGGGGAT -> GCCCCGGTCTTAGGGGATA
TGCCCGCCTCGAGCAGGTC -> GCCCGCCTCGAGCAGGTCT
TGCCCTAGTGAGTATTCTT -> GCCCTAGTGAGTATTCTTG
TGCCGCTTTCTTCTGGTGA -> GCCGCTTTCTTCTGGTGAA
TGCGAAGTACCAAACGCCA -> GCGAAGTACCAAACGCCAG
TGCGACTAGTCACAACTAC -> GCGACTAGTCACAACTACG
TGCGAGTATTACAGTCTAT -> GCGAGTATTACAGTCTATA
TGCGATCGTCGTGCTCAGT -> GCGATCGTCGTGCTCAGTA
TGCGCGTTGTTCGGATACT -> GCGCGTTGTTCGGATACTC
TGCGGAATATAGGCCTCTA -> GCGGAATATAGGCCTCTAG
TGCGGCGACTACTGGGGGT -> GCGGCGACTACTGGGGGTG
TGCGGTTGGGGAGAAGGGA -> GCGGTTGGGGAGAAGGGAC
TGCGTACTGGTGCTCCAGG -> GCGTACTGGTGCTCCAGGG
TGCGTAGCAGAGCAGTTCA -> GCGTAGCAGAGCAGTTCAT
TGCTACCATCGGGATCTTA -> GCTACCATCGGGATCTTAT
TGCTACTCGGAGGTTATGC -> GCTACTCGGAGGTTATGCA
TGCTAGAGCCATATTGACC -> GCTAGAGCCATATTGACCA
TGCTCAGTATGAAGAGCCT -> GCTCAGTATGAAGAGCCTT
TGCTCAGTATGAAGGACGT -> GCTCAGTATGAAGGACGTG
TGCTCAGTATGAAGGGACA -> GCTCAGTATGAAGGGACAG
TGCTCAGTATGAATAATCT -> GCTCAGTATGAATAATCTA
TGCTCCAGGGCACCTTCTC -> GCTCCAGGGCACCTTCTCA
TGCTCCGTTCGTTTGACTG -> GCTCCGTTCGTTTGACTGG
TGCTCGTCGTGCTCAGTAT -> GCTCGTCGTGCTCAGTATG
TGCTGCGAGTATTACAGTC -> GCTGCGAGTATTACAGTCT
TGCTGGTTCCAAAAACCGT -> GCTGGTTCCAAAAACCGTT
TGCTTATCGCACGCATGGA -> GCTTATCGCACGCATGGAC
TGGAAAGTGAGACACAAGC -> GGAAAGTGAGACACAAGCT
TGGACGAAATTATACATGA -> GGACGAAATTATACATGAG
TGGCACACTGCTACTCGGA -> GGCACACTGCTACTCGGAG
TGGCAGCGACAAAGTGAGA -> GGCAGCGACAAAGTGAGAC
TGGCAGTAAGAGTACACAC -> GGCAGTAAGAGTACACACA
TGGCCCCCTGTCTGTAAGC -> GGCCCCCTGTCTGTAAGCA
TGGCCGCTCCTTGGTACCT -> GGCCGCTCCTTGGTACCTA
TGGCGAGACTATCCCCGTA -> GGCGAGACTATCCCCGTAT
TGGCGAGTAATAGATAACT -> GGCGAGTAATAGATAACTG
TGGCGGCCGATTCCGCTTT -> GGCGGCCGATTCCGCTTTC
TGGCGTGAGCGACCTATAC -> GGCGTGAGCGACCTATACT
TGGCTAAGCCCGGCCTTAT -> GGCTAAGCCCGGCCTTATT
TGGCTCAGCAAACGGGGTC -> GGCTCAGCAAACGGGGTCC
TGGCTCGACAGGCGACTCG -> GGCTCGACAGGCGACTCGT
TGGCTGCGTACTGGTGCTC -> GGCTGCGTACTGGTGCTCC
TGGGCCTAGGCAGACCCGT -> GGGCCTAGGCAGACCCGTA
TGGGGAGAAGGGACAAACA -> GGGGAGAAGGGACAAACAG
TGGGGGTGGTAATGTACTG -> GGGGGTGGTAATGTACTGT
TGGGTAGATTTACCCTTAA -> GGGTAGATTTACCCTTAAT
TGGTAATGTACTGTGGCGA -> GGTAATGTACTGTGGCGAG
TGGTACCTATCCTGGCTGC -> GGTACCTATCCTGGCTGCG
TGGTATCATCTCACAATGT -> GGTATCATCTCACAATGTA
TGGTCGCTGGGCCTAGGCA -> GGTCGCTGGGCCTAGGCAG
TGGTGAATATAGAGGGCCA -> GGTGAATATAGAGGGCCAG
TGGTGCTCCAGGGCACCTT -> GGTGCTCCAGGGCACCTTC
TGGTTAAAATCGTCGCTCG -> GGTTAAAATCGTCGCTCGC
TGGTTCCAAAAACCGTTTT -> GGTTCCAAAAACCGTTTTA
TGTAAGCAATTGCTGGTTC -> GTAAGCAATTGCTGGTTCC
TGTACAGCGCGTCGTCGTG -> GTACAGCGCGTCGTCGTGC
TGTACATCCCGGGGAGGTG -> GTACATCCCGGGGAGGTGC
TGTACCCTTTTGGCAGCGA -> GTACCCTTTTGGCAGCGAC
TGTACGGTGATGCAGGGCG -> GTACGGTGATGCAGGGCGC
TGTACTGTGGCGAGTAATA -> GTACTGTGGCGAGTAATAG
TGTAGCTCGACACTCCCAA -> GTAGCTCGACACTCCCAAC
TGTATGAGCCATGCCCCGG -> GTATGAGCCATGCCCCGGT
TGTCACAATTACCAGCGCC -> GTCACAATTACCAGCGCCT
TGTCACTGACTCTTTGTCG -> GTCACTGACTCTTTGTCGC
TGTCGATCTACTGACGGCT -> GTCGATCTACTGACGGCTA
TGTCGCGGTAAGCGATAGG -> GTCGCGGTAAGCGATAGGT
TGTCGGGTCTTGAATAAAG -> GTCGGGTCTTGAATAAAGT
TGTCTCAAGCACACACCAA -> GTCTCAAGCACACACCAAA
TGTCTGCATCTGACGCTGG -> GTCTGCATCTGACGCTGGT
TGTCTGTAAGCAATTGCTG -> GTCTGTAAGCAATTGCTGG
TGTGAAAAGTGAGACACAA -> GTGAAAAGTGAGACACAAG
TGTGATCGTAAAACCACGG -> GTGATCGTAAAACCACGGA
TGTGCAATACGAGAACACT -> GTGCAATACGAGAACACTA
TGTGGCGAGTAATAGATAA -> GTGGCGAGTAATAGATAAC
TGTGGCTCAGCAAACGGGG -> GTGGCTCAGCAAACGGGGT
TGTGGCTCGACAGGCGACT -> GTGGCTCGACAGGCGACTC
TGTTAATTTCAACCTGTGA -> GTTAATTTCAACCTGTGAT
TGTTATAGGCCAGAACGAT -> GTTATAGGCCAGAACGATG
TGTTCCAACCTGCGGCGAC -> GTTCCAACCTGCGGCGACT
TGTTCCAATTTGCAGGTCA -> GTTCCAATTTGCAGGTCAA
TGTTCCATAATTGTCTGCA -> GTTCCATAATTGTCTGCAT
TGTTCGAAGAACGATAGTG -> GTTCGAAGAACGATAGTGC
TGTTCGGATACTCCCTCTG -> GTTCGGATACTCCCTCTGA
TGTTGAGCTGCGGAATATA -> GTTGAGCTGCGGAATATAG
TGTTGGGTAGATTTACCCT -> GTTGGGTAGATTTACCCTT
TTAAAAATACAGTCTGATG -> TAAAAATACAGTCTGATGC
TTAAAATCGTCGCTCGCCG -> TAAAATCGTCGCTCGCCGA
TTAAACTGCTACCATCGGG -> TAAACTGCTACCATCGGGA
TTAACCCTACCGTTCTGTG -> TAACCCTACCGTTCTGTGG
TTAAGGTTACGTTGAAGCA -> TAAGGTTACGTTGAAGCAT
TTAATTTCAACCTGTGATC -> TAATTTCAACCTGTGATCG
TTAATTTGATATCGTCATA -> TAATTTGATATCGTCATAC
TTAATTTTCCCTACCCCAA -> TAATTTTCCCTACCCCAAC
TTACACTACAAAAGAAATT -> TACACTACAAAAGAAATTT
TTACAGTCTATACTTCATG -> TACAGTCTATACTTCATGT
TTACATCATTGACAGATGG -> TACATCATTGACAGATGGC
TTACCAGCGCCTCGACATG -> TACCAGCGCCTCGACATGA
TTACCCGAATTCCATTGCG -> TACCCGAATTCCATTGCGA
TTACCCTTAATTTGATATC -> TACCCTTAATTTGATATCG
TTACGATTCGACAAGATGA -> TACGATTCGACAAGATGAC
TTACGCAGTACTCCGCCCG -> TACGCAGTACTCCGCCCGA
TTACGTTGAAGCATGGTTA -> TACGTTGAAGCATGGTTAA
TTACTCAGTTTAAACTGCT -> TACTCAGTTTAAACTGCTA
TTACTCTGCTTATCGCACG -> TACTCTGCTTATCGCACGC
TTAGATAAAGGCGGATTAT -> TAGATAAAGGCGGATTATT
TTAGCAGACCCCCGCAACC -> TAGCAGACCCCCGCAACCT
TTAGCATCGTAGCCGGTAG -> TAGCATCGTAGCCGGTAGC
TTAGCTTCAAACAAGTTTA -> TAGCTTCAAACAAGTTTAT
TTAGGGGATAACGTGCTGC -> TAGGGGATAACGTGCTGCG
TTAGTGAAAGATCGTGGAC -> TAGTGAAAGATCGTGGACG
TTATAACCCTACCTCCGGT -> TATAACCCTACCTCCGGTA
TTATACATGAGTGTTCCAT -> TATACATGAGTGTTCCATA
TTATAGGCCAGAACGATGT -> TATAGGCCAGAACGATGTT
TTATCAATTGAGTCCCCCT -> TATCAATTGAGTCCCCCTC
TTATGAAGATGAGTGTGAA -> TATGAAGATGAGTGTGAAA
TTATGCAATGATAATTCAC -> TATGCAATGATAATTCACA
TTATTACATCATTGACAGA -> TATTACATCATTGACAGAT
TTATTCGGTGTACCCTTTT -> TATTCGGTGTACCCTTTTG
TTATTGTTATAGGCCAGAA -> TATTGTTATAGGCCAGAAC
TTATTTGTCACAATTACCA -> TATTTGTCACAATTACCAG
TTCAAACAAGTTTATTCGG -> TCAAACAAGTTTATTCGGT
TTCAACCTGTGATCGTAAA -> TCAACCTGTGATCGTAAAA
TTCAAGATTAAAAATACAG -> TCAAGATTAAAAATACAGT
TTCAATGAGCGCCCGATAG -> TCAATGAGCGCCCGATAGG
TTCACAGGAGTAGACACCA -> TCACAGGAGTAGACACCAA
TTCACTAGTTAACCCTACC -> TCACTAGTTAACCCTACCG
TTCATCTGTTGAGCTGCGG -> TCATCTGTTGAGCTGCGGA
TTCATGGAAAGTGAGACAC -> TCATGGAAAGTGAGACACA
TTCATGTCGATCTACTGAC -> TCATGTCGATCTACTGACG
TTCCAAAAACCGTTTTATT -> TCCAAAAACCGTTTTATTG
TTCCAACCTGCGGCGACTA -> TCCAACCTGCGGCGACTAC
TTCCAATTTGCAGGTCAAT -> TCCAATTTGCAGGTCAATA
TTCCACATTAGATAAAGGC -> TCCACATTAGATAAAGGCG
TTCCATAATTGTCTGCATC -> TCCATAATTGTCTGCATCT
TTCCATTGCGACTAGTCAC -> TCCATTGCGACTAGTCACA
TTCCCTACCCCAACATAGT -> TCCCTACCCCAACATAGTT
TTCCCTTCGAGCTACCATC -> TCCCTTCGAGCTACCATCA
TTCCGAGGCTCCGATTAGC -> TCCGAGGCTCCGATTAGCA
TTCCGCTTTCATCTGTTGA -> TCCGCTTTCATCTGTTGAG
TTCGAAGAACGATAGTGCC -> TCGAAGAACGATAGTGCCC
TTCGACAAGATGACGAGAA -> TCGACAAGATGACGAGAAT
TTCGAGCTACCATCAGCTT -> TCGAGCTACCATCAGCTTT
TTCGGATACTCCCTCTGAG -> TCGGATACTCCCTCTGAGT
TTCGGTGTACCCTTTTGGC -> TCGGTGTACCCTTTTGGCA
TTCGTCGTGCTCAGTATGA -> TCGTCGTGCTCAGTATGAA
TTCGTTTGACTGGCCGCTC -> TCGTTTGACTGGCCGCTCC
TTCTCATTGCGGTTGGGGA -> TCTCATTGCGGTTGGGGAG
TTCTGGTGAATATAGAGGG -> TCTGGTGAATATAGAGGGC
TTCTGTCACTGACTCTTTG -> TCTGTCACTGACTCTTTGT
TTCTGTGGCTCGACAGGCG -> TCTGTGGCTCGACAGGCGA
TTCTTCTGGTGAATATAGA -> TCTTCTGGTGAATATAGAG
TTCTTGTCTCAAGCACACA -> TCTTGTCTCAAGCACACAC
TTGAAGCATGGTTAAAATC -> TGAAGCATGGTTAAAATCG
TTGAATAAAGTGAGACACA -> TGAATAAAGTGAGACACAA
TTGACAGATGGCAGTAAGA -> TGACAGATGGCAGTAAGAG
TTGACAGCTCCTAGAAGTG -> TGACAGCTCCTAGAAGTGA
TTGACCAATTTGTTCCAAC -> TGACCAATTTGTTCCAACC
TTGACTGGCCGCTCCTTGG -> TGACTGGCCGCTCCTTGGT
TTGAGCTGCGGAATATAGG -> TGAGCTGCGGAATATAGGC
TTGAGTCCCCCTCCTAATC -> TGAGTCCCCCTCCTAATCC
TTGATATCGTCATACTGCG -> TGATATCGTCATACTGCGC
TTGCAGGTCAATAAGGTTT -> TGCAGGTCAATAAGGTTTA
TTGCGACTAGTCACAACTA -> TGCGACTAGTCACAACTAC
TTGCGATCGTCGTGCTCAG -> TGCGATCGTCGTGCTCAGT
TTGCGGTTGGGGAGAAGGG -> TGCGGTTGGGGAGAAGGGA
TTGCTGGTTCCAAAAACCG -> TGCTGGTTCCAAAAACCGT
TTGGCACACTGCTACTCGG -> TGGCACACTGCTACTCGGA
TTGGCAGCGACAAAGTGAG -> TGGCAGCGACAAAGTGAGA
TTGGCGTGAGCGACCTATA -> TGGCGTGAGCGACCTATAC
TTGGCTAAGCCCGGCCTTA -> TGGCTAAGCCCGGCCTTAT
TTGGGGAGAAGGGACAAAC -> TGGGGAGAAGGGACAAACA
TTGGGTAGATTTACCCTTA -> TGGGTAGATTTACCCTTAA
TTGGTACCTATCCTGGCTG -> TGGTACCTATCCTGGCTGC
TTGGTATCATCTCACAATG -> TGGTATCATCTCACAATGT
TTGTACGGTGATGCAGGGC -> TGTACGGTGATGCAGGGCG
TTGTCACAATTACCAGCGC -> TGTCACAATTACCAGCGCC
TTGTCGCGGTAAGCGATAG -> TGTCGCGGTAAGCGATAGG
TTGTCTCAAGCACACACCA -> TGTCTCAAGCACACACCAA
TTGTCTGCATCTGACGCTG -> TGTCTGCATCTGACGCTGG
TTGTTATAGGCCAGAACGA -> TGTTATAGGCCAGAACGAT
TTGTTCCAACCTGCGGCGA -> TGTTCCAACCTGCGGCGAC
TTGTTCGGATACTCCCTCT -> TGTTCGGATACTCCCTCTG
TTTAAACTGCTACCATCGG -> TTAAACTGCTACCATCGGG
TTTACCCGAATTCCATTGC -> TTACCCGAATTCCATTGCG
TTTACCCTTAATTTGATAT -> TTACCCTTAATTTGATATC
TTTACGCAGTACTCCGCCC -> TTACGCAGTACTCCGCCCG
TTTAGCAGACCCCCGCAAC -> TTAGCAGACCCCCGCAACC
TTTAGCTTCAAACAAGTTT -> TTAGCTTCAAACAAGTTTA
TTTATGAAGATGAGTGTGA -> TTATGAAGATGAGTGTGAA
TTTATTCGGTGTACCCTTT -> TTATTCGGTGTACCCTTTT
TTTATTGTTATAGGCCAGA -> TTATTGTTATAGGCCAGAA
TTTCAACCTGTGATCGTAA -> TTCAACCTGTGATCGTAAA
TTTCACTAGTTAACCCTAC -> TTCACTAGTTAACCCTACC
TTTCATCTGTTGAGCTGCG -> TTCATCTGTTGAGCTGCGG
TTTCCCTACCCCAACATAG -> TTCCCTACCCCAACATAGT
TTTCCCTTCGAGCTACCAT -> TTCCCTTCGAGCTACCATC
TTTCCGAGGCTCCGATTAG -> TTCCGAGGCTCCGATTAGC
TTTCGTCGTGCTCAGTATG -> TTCGTCGTGCTCAGTATGA
TTTCTTCTGGTGAATATAG -> TTCTTCTGGTGAATATAGA
TTTGACAGCTCCTAGAAGT -> TTGACAGCTCCTAGAAGTG
TTTGACTGGCCGCTCCTTG -> TTGACTGGCCGCTCCTTGG
TTTGATATCGTCATACTGC -> TTGATATCGTCATACTGCG
TTTGCAGGTCAATAAGGTT -> TTGCAGGTCAATAAGGTTT
TTTGCGATCGTCGTGCTCA -> TTGCGATCGTCGTGCTCAG
TTTGGCAGCGACAAAGTGA -> TTGGCAGCGACAAAGTGAG
TTTGGCGTGAGCGACCTAT -> TTGGCGTGAGCGACCTATA
TTTGGCTAAGCCCGGCCTT -> TTGGCTAAGCCCGGCCTTA
TTTGGTATCATCTCACAAT -> TTGGTATCATCTCACAATG
TTTGTCACAATTACCAGCG -> TTGTCACAATTACCAGCGC
TTTGTCGCGGTAAGCGATA -> TTGTCGCGGTAAGCGATAG
TTTGTTCCAACCTGCGGCG -> TTGTTCCAACCTGCGGCGA
TTTTACCCGAATTCCATTG -> TTTACCCGAATTCCATTGC
TTTTATTGTTATAGGCCAG -> TTTATTGTTATAGGCCAGA
TTTTCCCTACCCCAACATA -> TTTCCCTACCCCAACATAG
TTTTGGCAGCGACAAAGTG -> TTTGGCAGCGACAAAGTGA
